23;Erik Karlsson;OTT;OTT;D;82;21;45;66;63;90;153;6500000;1
50;Brent Burns;SJS;SJS;D;82;17;43;60;51;86;137;5760000;2
53;P.K. Subban;MTL;MTL;D;82;15;45;60;45;90;135;9000000;3
4;Alex Ovechkin;WAS;WSH;L;81;53;28;81;106;28;134;9538000;4
61;Dennis Wideman;CGY;CGY;D;80;15;41;56;45;82;127;5250000;5
65;Roman Josi;NAS;NSH;D;81;15;40;55;45;80;125;4000000;6
2;John Tavares;NYI;NYI;C;82;38;48;86;76;48;124;5500000;7
1;Jamie Benn;DAL;DAL;L;82;35;52;87;70;52;122;5250000;8
63;John Carlson;WAS;WSH;D;82;12;43;55;36;86;122;3967000;9
73;Kris Letang;PIT;PIT;D;69;11;43;54;33;86;119;7250000;10
78;Tyson Barrie;COL;COL;D;80;12;41;53;36;82;118;2600000;11
15;Steven Stamkos;TBL;TBL;C;82;43;29;72;86;29;115;7500000;12
7;Tyler Seguin;DAL;DAL;C;71;37;40;77;74;40;114;5750000;13
82;Mark Streit;PHI;PHI;D;81;9;43;52;27;86;113;5250000;14
91;Justin Faulk;CAR;CAR;D;82;15;34;49;45;68;113;4833000;15
3;Sidney Crosby;PIT;PIT;C;77;28;56;84;56;56;112;8700000;16
20;Rick Nash;NYR;NYR;L;79;42;27;69;84;27;111;7800000;17
13;Vladimir Tarasenko;STL;STL;R;77;37;36;73;74;36;110;7500000;18
84;Keith Yandle;NYR;ARI, NYR;D;84;6;46;52;18;92;110;2625000;19
87;Andrei Markov;MTL;MTL;D;81;10;40;50;30;80;110;5750000;20
129;Oliver Ekman-Larsson;ARI;ARI;D;82;23;20;43;69;40;109;5500000;21
114;Dustin Byfuglien;WPG;WPG;D;69;18;27;45;54;54;108;5200000;22
8;Jiri Hudler;CGY;CGY;C;78;31;45;76;62;45;107;4000000;23
19;Joe Pavelski;SJS;SJS;C;82;37;33;70;74;33;107;6000000;24
97;Mark Giordano;CGY;CGY;D;61;11;37;48;33;74;107;4019999;25
118;Shea Weber;NAS;NSH;D;78;15;30;45;45;60;105;7857000;26
10;Nick Foligno;CLB;CBJ;L;79;31;42;73;62;42;104;5500000;27
22;Max Pacioretty;MTL;MTL;L;80;37;30;67;74;30;104;4500000;28
5;Jakub Voracek;PHI;PHI;R;82;22;59;81;44;59;103;4250000;29
14;Tyler Johnson;TBL;TBL;C;77;29;43;72;58;43;101;3333000;30
115;Mike Green;DET;WSH;D;72;10;35;45;30;70;100;6000000;31
117;Duncan Keith;CHI;CHI;D;80;10;35;45;30;70;100;5538000;32
107;Drew Doughty;LAK;LAK;D;82;7;39;46;21;78;99;7000000;33
111;Alex Pietrangelo;STL;STL;D;81;7;39;46;21;78;99;6500000;34
11;Claude Giroux;PHI;PHI;C;81;25;48;73;50;48;98;8275000;35
18;Evgeni Malkin;PIT;PIT;C;69;28;42;70;56;42;98;9500000;36
16;Ryan Johansen;CLB;CBJ;C;82;26;45;71;52;45;97;4000000;37
121;Niklas Kronwall;DET;DET;D;80;9;35;44;27;70;97;4750000;38
6;Nicklas Backstrom;WAS;WSH;C;82;18;60;78;36;60;96;6700000;39
9;Daniel Sedin;VAN;VAN;L;82;20;56;76;40;56;96;7000000;40
124;Kevin Shattenkirk;STL;STL;D;56;8;36;44;24;72;96;4250000;41
17;Ryan Getzlaf;ANA;ANA;C;77;25;45;70;50;45;95;8250000;42
43;Zach Parise;MIN;MIN;L;74;33;29;62;66;29;95;7538000;43
21;Logan Couture;SJS;SJS;C;82;27;40;67;54;40;94;6000000;44
24;Jonathan Toews;CHI;CHI;C;81;28;38;66;56;38;94;10500000;45
27;Nikita Kucherov;TBL;TBL;R;82;29;36;65;58;36;94;894000;46
39;Radim Vrbata;VAN;VAN;R;79;31;32;63;62;32;94;5000000;47
136;Dougie Hamilton;CGY;BOS;D;72;10;32;42;30;64;94;5750000;48
42;Sean Monahan;CGY;CGY;C;81;31;31;62;62;31;93;1775000;49
141;TJ Brodie;CGY;CGY;D;81;11;30;41;33;60;93;4650000;50
145;Jake Muzzin;LAK;LAK;D;76;10;31;41;30;62;92;4000000;51
166;Trevor Daley;CHI;DAL;D;68;16;22;38;48;44;92;3300000;52
12;Henrik Sedin;VAN;VAN;C;82;18;55;73;36;55;91;7000000;53
26;Pavel Datsyuk;DET;DET;C;63;26;39;65;52;39;91;7500000;54
30;Patrick Kane;CHI;CHI;R;61;27;37;64;54;37;91;10500000;55
38;Jaden Schwartz;STL;STL;L;75;28;35;63;56;35;91;2350000;56
152;John Klingberg;DAL;DAL;D;65;11;29;40;33;58;91;4250000;57
33;Mark Stone;OTT;OTT;R;80;26;38;64;52;38;90;3500000;58
40;Jeff Carter;LAK;LAK;C;82;28;34;62;56;34;90;5273000;59
157;Aaron Ekblad;FLA;FLA;D;81;12;27;39;36;54;90;4250000;60
161;Torey Krug;BOS;BOS;D;78;12;27;39;36;54;90;3400000;61
36;Filip Forsberg;NAS;NSH;C;82;26;37;63;52;37;89;1461000;62
29;Johnny Gaudreau;CGY;CGY;L;80;24;40;64;48;40;88;1850000;63
32;Alexander Steen;STL;STL;L;74;24;40;64;48;40;88;5800000;64
34;Kyle Turris;OTT;OTT;C;82;24;40;64;48;40;88;3500000;65
51;Scott Hartnell;CLB;CBJ;L;77;28;32;60;56;32;88;4750000;66
54;Jarome Iginla;COL;COL;R;82;29;30;59;58;30;88;5333000;67
68;Corey Perry;ANA;ANA;R;67;33;22;55;66;22;88;8625000;68
151;Jack Johnson;CLB;CBJ;D;79;8;32;40;24;64;88;4357000;69
35;Jordan Eberle;EDM;EDM;R;81;24;39;63;48;39;87;6000000;70
48;Blake Wheeler;WPG;WPG;R;79;26;35;61;52;35;87;5600000;71
164;Anton Stralman;TBL;TBL;D;82;9;30;39;27;60;87;4500000;72
41;Andrew Ladd;WPG;WPG;L;81;24;38;62;48;38;86;4400000;73
47;Phil Kessel;PIT;TOR;R;82;25;36;61;50;36;86;6800000;74
52;Tomas Plekanec;MTL;MTL;C;82;26;34;60;52;34;86;5000000;75
168;Victor Hedman;TBL;TBL;D;59;10;28;38;30;56;86;4000000;76
179;Sami Vatanen;ANA;ANA;D;67;12;25;37;36;50;86;1262000;77
59;Tomas Tatar;DET;DET;L;82;29;27;56;58;27;85;2750000;78
56;David Backes;STL;STL;C;80;26;32;58;52;32;84;4500000;79
175;Nick Leddy;NYI;NYI;D;78;10;27;37;30;54;84;5500000;80
25;Henrik Zetterberg;DET;DET;L;77;17;49;66;34;49;83;6083000;81
46;Marian Hossa;CHI;CHI;R;82;22;39;61;44;39;83;5275000;82
60;James van Riemsdyk;TOR;TOR;L;82;27;29;56;54;29;83;5250000;83
187;David Savard;CLB;CBJ;D;82;11;25;36;33;50;83;1300000;84
55;Gabriel Landeskog;COL;COL;L;82;23;36;59;46;36;82;5571000;85
28;Joe Thornton;SJS;SJS;C;78;16;49;65;32;49;81;6750000;86
74;Gustav Nyquist;DET;DET;R;82;27;27;54;54;27;81;4750000;87
31;Anze Kopitar;LAK;LAK;C;79;16;48;64;32;48;80;6800000;88
58;Ryan Nugent-Hopkins;EDM;EDM;C;76;24;32;56;48;32;80;6000000;89
37;Ondrej Palat;TBL;TBL;L;75;16;47;63;32;47;79;3333000;90
45;Jason Spezza;DAL;DAL;C;82;17;45;62;34;45;79;7500000;91
49;Derick Brassard;NYR;NYR;C;80;19;41;60;38;41;79;5000000;92
183;Cody Franson;NAS;TOR, NSH;D;78;7;29;36;21;58;79;0;93
191;Johnny Boychuk;NYI;NYI;D;72;9;26;35;27;52;79;6000000;94
62;Patrice Bergeron;BOS;BOS;C;81;23;32;55;46;32;78;6875000;95
71;Ryan Callahan;TBL;TBL;R;77;24;30;54;48;30;78;5800000;96
88;Wayne Simmonds;PHI;PHI;R;75;28;22;50;56;22;78;3975000;97
171;Ryan Suter;MIN;MIN;D;77;2;36;38;6;72;78;7538000;98
44;Mike Ribeiro;NAS;NSH;C;82;15;47;62;30;47;77;3500000;99
70;Alex Tanguay;COL;COL;L;80;22;33;55;44;33;77;3500000;100
77;Eric Staal;CAR;CAR;C;77;23;31;54;46;31;77;8250000;101
57;Patrick Marleau;SJS;SJS;L;82;19;38;57;38;38;76;6667000;102
64;Matt Duchene;COL;COL;C;82;21;34;55;42;34;76;6000000;103
79;Bryan Little;WPG;WPG;C;70;24;28;52;48;28;76;4700000;104
85;Patric Hornqvist;PIT;PIT;R;64;25;26;51;50;26;76;4250000;105
184;Alex Goligoski;DAL;DAL;D;81;4;32;36;12;64;76;4600000;106
210;James Wisniewski;CAR;CBJ, ANA;D;69;8;26;34;24;52;76;5500000;107
80;Brandon Saad;CLB;CHI;L;82;23;29;52;46;29;75;6000000;108
98;Mike Hoffman;OTT;OTT;L;79;27;21;48;54;21;75;2000000;109
199;Cam Fowler;ANA;ANA;D;80;7;27;34;21;54;75;4000000;110
201;Hampus Lindholm;ANA;ANA;D;78;7;27;34;21;54;75;1744000;111
211;Marek Zidlicky;DET;NJD, DET;D;84;7;27;34;21;54;75;0;112
67;T.J. Oshie;WAS;STL;R;72;19;36;55;38;36;74;4175000;113
101;Marian Gaborik;LAK;LAK;R;69;27;20;47;54;20;74;4875000;114
217;Ryan McDonagh;NYR;NYR;D;71;8;25;33;24;50;74;4700000;115
224;Michael Del Zotto;PHI;PHI;D;64;10;22;32;30;44;74;3875000;116
81;Martin St. Louis;#N/A;NYR;R;74;21;31;52;42;31;73;0;117
83;Thomas Vanek;MIN;MIN;L;80;21;31;52;42;31;73;6500000;118
66;Ryan O'Reilly;BUF;COL;C;82;17;38;55;34;38;72;6000000;119
75;Jason Pominville;MIN;MIN;R;82;18;36;54;36;36;72;5600000;120
76;Bobby Ryan;OTT;OTT;R;78;18;36;54;36;36;72;7250000;121
90;Tyler Bozak;TOR;TOR;C;82;23;26;49;46;26;72;4250000;122
93;Tyler Toffoli;LAK;LAK;C;76;23;26;49;46;26;72;3250000;123
206;Kris Russell;CGY;CGY;D;79;4;30;34;12;60;72;2600000;124
69;Derek Stepan;NYR;NYR;C;68;16;39;55;32;39;71;6500000;125
102;Brendan Gallagher;MTL;MTL;R;82;24;23;47;48;23;71;3750000;126
214;Travis Hamonic;NYI;NYI;D;71;5;28;33;15;56;71;3857000;127
232;Alexander Edler;VAN;VAN;D;74;8;23;31;24;46;70;5000000;128
240;Brent Seabrook;CHI;CHI;D;82;8;23;31;24;46;70;5800000;129
72;Jonathan Huberdeau;FLA;FLA;L;79;15;39;54;30;39;69;894000;130
86;Kyle Okposo;NYI;NYI;R;60;18;33;51;36;33;69;2800000;131
100;Loui Eriksson;BOS;BOS;R;81;22;25;47;44;25;69;4250000;132
134;Mike Cammalleri;NJD;NJD;L;68;27;15;42;54;15;69;5000000;133
239;Justin Schultz;EDM;EDM;D;81;6;25;31;18;50;68;3900000;134
89;Ryan Strome;NYI;NYI;C;81;17;33;50;34;33;67;1713000;135
104;Marcus Johansson;WAS;WSH;L;82;20;27;47;40;27;67;3750000;136
105;Ryan Kesler;ANA;ANA;C;81;20;27;47;40;27;67;5000000;137
110;Chris Kreider;NYR;NYR;L;80;21;25;46;42;25;67;2475000;138
119;Justin Abdelkader;DET;DET;L;71;23;21;44;46;21;67;1800000;139
125;Craig Smith;NAS;NSH;C;82;23;21;44;46;21;67;4250000;140
127;Nick Bjugstad;FLA;FLA;C;72;24;19;43;48;19;67;4099999;141
108;Tyler Ennis;BUF;BUF;C;78;20;26;46;40;26;66;4600000;142
109;Alex Galchenyuk;MTL;MTL;C;80;20;26;46;40;26;66;2800000;143
113;Mika Zibanejad;OTT;OTT;C;80;20;26;46;40;26;66;2625000;144
137;Brad Marchand;BOS;BOS;L;77;24;18;42;48;18;66;4500000;145
143;Anders Lee;NYI;NYI;C;76;25;16;41;50;16;66;3750000;146
237;Matt Niskanen;WAS;WSH;D;82;4;27;31;12;54;66;5750000;147
252;Morgan Rielly;TOR;TOR;D;81;8;21;29;24;42;66;2750000;148
106;Brayden Schenn;PHI;PHI;C;82;18;29;47;36;29;65;2500000;149
92;Mark Scheifele;WPG;WPG;C;82;15;34;49;30;34;64;1563000;150
94;Mats Zuccarello;NYR;NYR;R;78;15;34;49;30;34;64;4500000;151
103;Jaromir Jagr;FLA;NJD, FLA;R;77;17;30;47;34;30;64;5405000;152
128;Troy Brouwer;STL;WSH;R;82;21;22;43;42;22;64;3667000;153
231;Danny DeKeyser;DET;DET;D;80;2;29;31;6;58;64;2188000;154
243;Jason Garrison;TBL;TBL;D;70;4;26;30;12;52;64;4600000;155
260;Tyler Myers;WPG;BUF, WPG;D;71;7;21;28;21;42;63;5500000;156
270;Ryan Ellis;NAS;NSH;D;58;9;18;27;27;36;63;2500000;157
95;David Desharnais;MTL;MTL;C;82;14;34;48;28;34;62;3500000;158
99;Mikko Koivu;MIN;MIN;C;80;14;34;48;28;34;62;6750000;159
112;Paul Stastny;STL;STL;C;74;16;30;46;32;30;62;7000000;160
116;Kevin Hayes;NYR;NYR;R;79;17;28;45;34;28;62;3750000;161
123;Milan Lucic;LAK;BOS;L;81;18;26;44;36;26;62;3250000;162
138;Brock Nelson;NYI;NYI;C;82;20;22;42;40;22;62;0;163
139;Colin Wilson;NAS;NSH;C;77;20;22;42;40;22;62;3938000;164
149;Cam Atkinson;CLB;CBJ;R;78;22;18;40;44;18;62;3500000;165
272;Seth Jones;NAS;NSH;D;82;8;19;27;24;38;62;3225000;166
133;Drew Stafford;WPG;BUF, WPG;R;76;18;25;43;36;25;61;4350000;167
135;Michael Frolik;CGY;WPG;R;82;19;23;42;38;23;61;4300000;168
177;Nino Niederreiter;MIN;MIN;R;80;24;13;37;48;13;61;2667000;169
251;Dion Phaneuf;TOR;TOR;D;70;3;26;29;9;52;61;0;170
281;Kevin Klein;NYR;NYR;D;65;9;17;26;27;34;61;2900000;171
96;Valtteri Filppula;TBL;TBL;C;82;12;36;48;24;36;60;5000000;172
156;Erik Cole;DET;DAL, DET;L;68;21;18;39;42;18;60;0;173
176;James Neal;NAS;NSH;L;67;23;14;37;46;14;60;5000000;174
130;Adam Henrique;NJD;NJD;C;75;16;27;43;32;27;59;4000000;175
132;Patrick Sharp;DAL;CHI;L;68;16;27;43;32;27;59;5900000;176
146;Mathieu Perreault;WPG;WPG;C;62;18;23;41;36;23;59;3000000;177
148;Justin Williams;WAS;LAK;R;81;18;23;41;36;23;59;3250000;178
150;Cody Eakin;DAL;DAL;C;78;19;21;40;38;21;59;1900000;179
296;Jared Spurgeon;MIN;MIN;D;66;9;16;25;27;32;59;2667000;180
122;Jori Lehtera;STL;STL;C;75;14;30;44;28;30;58;2750000;181
147;David Perron;PIT;EDM, PIT;L;81;17;24;41;34;24;58;3812000;182
158;Mike Fisher;NAS;NSH;C;59;19;20;39;38;20;58;4400000;183
317;Erik Johnson;COL;COL;D;47;12;11;23;36;22;58;3750000;184
126;Carl Soderberg;COL;BOS;C;82;13;31;44;26;31;57;4750000;185
131;Frans Nielsen;NYI;NYI;C;78;14;29;43;28;29;57;2750000;186
153;Chris Kunitz;PIT;PIT;L;74;17;23;40;34;23;57;3850000;187
160;Nazem Kadri;TOR;TOR;C;73;18;21;39;36;21;57;4200000;188
267;Brian Campbell;FLA;FLA;D;82;3;24;27;9;48;57;0;189
309;Francois Beauchemin;COL;ANA;D;64;11;12;23;33;24;57;4500000;190
321;Marco Scandella;MIN;MIN;D;64;11;12;23;33;24;57;4000000;191
140;Josh Bailey;NYI;NYI;L;70;15;26;41;30;26;56;3300000;192
142;Sam Gagner;PHI;ARI;C;81;15;26;41;30;26;56;3200000;193
162;Elias Lindholm;CAR;CAR;C;81;17;22;39;34;22;56;1775000;194
288;Jason Demers;DAL;SJS, DAL;D;81;5;20;25;15;40;55;2210000;195
324;Marc-Edouard Vlasic;SJS;SJS;D;70;9;14;23;27;28;55;4250000;196
144;Matt Moulson;BUF;BUF;L;77;13;28;41;26;28;54;5000000;197
155;Nick Bonino;PIT;VAN;C;75;15;24;39;30;24;54;1900000;198
196;Jimmy Hayes;BOS;FLA;R;72;19;16;35;38;16;54;2300000;199
220;Brandon Sutter;VAN;PIT;C;80;21;12;33;42;12;54;3300000;200
222;Matt Beleskey;BOS;ANA;L;65;22;10;32;44;10;54;3800000;201
154;Reilly Smith;FLA;BOS;R;81;13;27;40;26;27;53;3575000;202
169;Alex Killorn;TBL;TBL;C;71;15;23;38;30;23;53;2550000;203
204;Benoit Pouliot;EDM;EDM;L;58;19;15;34;38;15;53;4000000;204
208;Joel Ward;SJS;WSH;R;82;19;15;34;38;15;53;3275000;205
347;Yannick Weber;VAN;VAN;D;65;11;10;21;33;20;53;1500000;206
120;Jussi Jokinen;FLA;FLA;L;81;8;36;44;16;36;52;4021000;207
163;Jakob Silfverberg;ANA;ANA;R;81;13;26;39;26;26;52;3750000;208
165;Brad Boyes;#N/A;FLA;R;78;14;24;38;28;24;52;99999999;209
167;Taylor Hall;EDM;EDM;L;53;14;24;38;28;24;52;6000000;210
170;Nathan MacKinnon;COL;COL;C;64;14;24;38;28;24;52;3775000;211
173;Sean Couturier;PHI;PHI;C;82;15;22;37;30;22;52;1750000;212
180;Aleksander Barkov;FLA;FLA;C;71;16;20;36;32;20;52;4000000;213
186;Clarke MacArthur;OTT;OTT;L;62;16;20;36;32;20;52;4650000;214
195;Carl Hagelin;ANA;NYR;L;82;17;18;35;34;18;52;4000000;215
213;Eric Fehr;PIT;WSH;C;75;19;14;33;38;14;52;2000000;216
300;Jake Gardiner;TOR;TOR;D;79;4;20;24;12;40;52;7000000;217
172;Antoine Vermette;ARI;ARI, CHI;C;82;13;25;38;26;25;51;3750000;218
190;Tommy Wingels;SJS;SJS;C;75;15;21;36;30;21;51;2475000;219
212;Alexandre Burrows;VAN;VAN;R;70;18;15;33;36;15;51;4500000;220
304;Adam Larsson;NJD;NJD;D;64;3;21;24;9;42;51;4167000;221
334;Jeff Petry;MTL;EDM, MTL;D;78;7;15;22;21;30;51;5500000;222
336;Jacob Trouba;WPG;WPG;D;65;7;15;22;21;30;51;1827000;223
339;Kevin Connauton;CLB;DAL, CBJ;D;62;9;12;21;27;24;51;683000;224
181;Shane Doan;ARI;ARI;R;79;14;22;36;28;22;50;5300000;225
189;Chris Stewart;ANA;BUF, MIN;R;81;14;22;36;28;22;50;1700000;226
197;Lance Bouma;CGY;CGY;C;78;16;18;34;32;18;50;2200000;227
305;Brayden McNabb;LAK;LAK;D;71;2;22;24;6;44;50;650000;228
315;Toby Enstrom;WPG;WPG;D;60;4;19;23;12;38;50;5750000;229
332;Alec Martinez;LAK;LAK;D;56;6;16;22;18;32;50;4000000;230
178;Brad Richards;DET;CHI;C;76;12;25;37;24;25;49;4000000;231
182;Brandon Dubinsky;CLB;CBJ;C;47;13;23;36;26;23;49;5850000;232
188;Riley Sheahan;DET;DET;C;79;13;23;36;26;23;49;950000;233
215;Jannik Hansen;VAN;VAN;R;81;16;17;33;32;17;49;2500000;234
241;Jeff Skinner;CAR;CAR;L;77;18;13;31;36;13;49;5725000;235
261;Michael Raffl;PHI;PHI;L;67;21;7;28;42;7;49;1100000;236
314;Simon Despres;ANA;PIT, ANA;D;75;3;20;23;9;40;49;900000;237
323;Andrej Sekera;EDM;CAR, LAK;D;73;3;20;23;9;40;49;5500000;238
350;Dan Boyle;NYR;NYR;D;65;9;11;20;27;22;49;4500000;239
174;Evgeny Kuznetsov;WAS;WSH;C;80;11;26;37;22;26;48;3000000;240
185;Chris Higgins;VAN;VAN;L;77;12;24;36;24;24;48;2500000;241
193;Brian Gionta;BUF;BUF;R;69;13;22;35;26;22;48;4250000;242
194;Curtis Glencross;WAS;CGY, WSH;L;71;13;22;35;26;22;48;0;243
207;Kris Versteeg;CHI;CHI;L;61;14;20;34;28;20;48;2200000;244
216;Darren Helm;DET;DET;C;75;15;18;33;30;18;48;2125000;245
223;Steve Bernier;NJD;NJD;R;67;16;16;32;32;16;48;0;246
229;Mark Arcobello;TOR;EDM, NSH, PIT, ARI;R;77;17;14;31;34;14;48;1500000;247
352;Zdeno Chara;BOS;BOS;D;63;8;12;20;24;24;48;6917000;248
362;Rasmus Ristolainen;BUF;BUF;D;78;8;12;20;24;24;48;1775000;249
159;Mikael Granlund;MIN;MIN;C;68;8;31;39;16;31;47;3000000;250
198;Patrik Elias;NJD;NJD;C;69;13;21;34;26;21;47;5500000;251
203;Milan Michalek;OTT;OTT;L;66;13;21;34;26;21;47;4000000;252
221;Nail Yakupov;EDM;EDM;R;81;14;19;33;28;19;47;2500000;253
230;Blake Comeau;COL;PIT;L;61;16;15;31;32;15;47;2400000;254
286;Jason Zucker;MIN;MIN;L;51;21;5;26;42;5;47;900000;255
311;Justin Braun;SJS;SJS;D;70;1;22;23;3;44;47;3800000;256
316;Dan Hamhuis;VAN;VAN;D;59;1;22;23;3;44;47;4500000;257
327;Andy Greene;NJD;NJD;D;82;3;19;22;9;38;47;5000000;258
330;Dmitry Kulikov;FLA;FLA;D;73;3;19;22;9;38;47;7140000;259
337;Karl Alzner;WAS;WSH;D;82;5;16;21;15;32;47;2800000;260
338;Cody Ceci;OTT;OTT;D;81;5;16;21;15;32;47;1369000;261
192;Charlie Coyle;MIN;MIN;C;82;11;24;35;22;24;46;3200000;262
205;Teddy Purcell;EDM;EDM;R;82;12;22;34;24;22;46;4500000;263
236;Nikolay Kulemin;NYI;NYI;L;82;15;16;31;30;16;46;4187999;264
306;Brandon Pirri;FLA;FLA;C;49;22;2;24;44;2;46;1200000;265
328;Thomas Hickey;NYI;NYI;D;81;2;20;22;6;40;46;2200000;266
331;John-Michael Liles;CAR;CAR;D;57;2;20;22;6;40;46;3875000;267
375;Matt Irwin;BOS;SJS;D;53;8;11;19;24;22;46;800000;268
219;Mike Santorelli;ANA;TOR, NSH;C;79;12;21;33;24;21;45;875000;269
242;Jiri Tlusty;WPG;CAR, WPG;C;72;14;17;31;28;17;45;0;270
244;Zemgus Girgensons;BUF;BUF;C;61;15;15;30;30;15;45;1369000;271
274;Shawn Matthias;TOR;VAN;C;78;18;9;27;36;9;45;2950000;272
361;Zach Redmond;COL;COL;D;59;5;15;20;15;30;45;750000;273
364;Marc Staal;NYR;NYR;D;80;5;15;20;15;30;45;5700000;274
367;Lubomir Visnovsky;NYI;NYI;D;53;5;15;20;15;30;45;0;275
218;Victor Rask;CAR;CAR;C;80;11;22;33;22;22;44;863000;276
228;Derek Roy;EDM;NSH, EDM;C;72;12;20;32;24;20;44;0;277
234;Tomas Hertl;SJS;SJS;C;82;13;18;31;26;18;44;1350000;278
245;David Jones;CGY;CGY;R;67;14;16;30;28;16;44;4000000;279
247;Andrew Cogliano;ANA;ANA;L;82;15;14;29;30;14;44;3000000;280
354;Dan Girardi;NYR;NYR;D;82;4;16;20;12;32;44;5500000;281
372;Eric Gelinas;NJD;NJD;D;61;6;13;19;18;26;44;1575000;282
202;Patrick Maroon;ANA;ANA;L;71;9;25;34;18;25;43;2000000;283
209;Daniel Winnik;TOR;TOR, PIT;C;79;9;25;34;18;25;43;2300000;284
227;Ales Hemsky;DAL;DAL;R;76;11;21;32;22;21;43;4000000;285
250;Kyle Palmieri;NJD;ANA;C;57;14;15;29;28;15;43;1467000;286
262;Lee Stempniak;WPG;NYR, WPG;R;71;15;13;28;30;13;43;0;287
349;Zach Bogosian;BUF;WPG, BUF;D;62;3;17;20;9;34;43;5143000;288
359;Paul Martin;SJS;PIT;D;74;3;17;20;9;34;43;4850000;289
383;Mattias Ekholm;NAS;NSH;D;80;7;11;18;21;22;43;1038000;290
248;Vernon Fiddler;DAL;DAL;C;80;13;16;29;26;16;42;1250000;291
254;Bryan Bickell;CHI;CHI;L;80;14;14;28;28;14;42;4000000;292
255;Mikkel Boedker;ARI;ARI;L;45;14;14;28;28;14;42;3750000;293
257;Steve Downie;ARI;PIT;R;72;14;14;28;28;14;42;1750000;294
269;Lars Eller;MTL;MTL;C;77;15;12;27;30;12;42;3500000;295
355;Oscar Klefbom;EDM;EDM;D;60;2;18;20;6;36;42;1244000;296
365;Christopher Tanev;VAN;VAN;D;70;2;18;20;6;36;42;4450000;297
200;Scott Gomez;NJD;NJD;C;58;7;27;34;14;27;41;0;298
226;Martin Erat;ARI;ARI;R;79;9;23;32;18;23;41;0;299
268;Patrick Eaves;DAL;DAL;R;47;14;13;27;28;13;41;1150000;300
285;Andrew Shaw;CHI;CHI;R;79;15;11;26;30;11;41;2000000;301
374;Niklas Hjalmarsson;CHI;CHI;D;82;3;16;19;9;32;41;4099999;302
233;Justin Fontaine;MIN;MIN;R;71;9;22;31;18;22;40;1000000;303
238;Rickard Rakell;ANA;ANA;C;71;9;22;31;18;22;40;894000;304
249;Shawn Horcoff;ANA;DAL;C;76;11;18;29;22;18;40;1750000;305
381;Matthew Carle;TBL;TBL;D;59;4;14;18;12;28;40;5500000;306
410;Matt Dumba;MIN;MIN;D;58;8;8;16;24;16;40;1603000;307
253;Dale Weise;MTL;MTL;R;79;10;19;29;20;19;39;1024999;308
265;Patrik Berglund;STL;STL;C;77;12;15;27;24;15;39;3700000;309
280;Dwight King;LAK;LAK;L;81;13;13;26;26;13;39;1950000;310
299;Brian Boyle;TBL;TBL;C;82;15;9;24;30;9;39;2000000;311
390;Kyle Quincey;DET;DET;D;73;3;15;18;9;30;39;4250000;312
393;Michael Stone;ARI;ARI;D;81;3;15;18;9;30;39;3000000;313
397;Ian Cole;PIT;STL, PIT;D;74;5;12;17;15;24;39;2100000;314
403;Damon Severson;NJD;NJD;D;51;5;12;17;15;24;39;888000;315
235;David Krejci;BOS;BOS;C;47;7;24;31;14;24;38;7250000;316
246;Matt Read;PHI;PHI;R;80;8;22;30;16;22;38;3625000;317
258;Nathan Gerbe;CAR;CAR;L;78;10;18;28;20;18;38;1750000;318
266;Dustin Brown;LAK;LAK;R;82;11;16;27;22;16;38;5875000;319
292;Bo Horvat;VAN;VAN;C;68;13;12;25;26;12;38;1744000;320
295;Antoine Roussel;DAL;DAL;L;80;13;12;25;26;12;38;2000000;321
376;Brooks Orpik;WAS;WSH;D;78;0;19;19;0;38;38;5500000;322
264;Mikael Backlund;CGY;CGY;C;52;10;17;27;20;17;37;3575000;323
275;Dominic Moore;NYR;NYR;C;82;10;17;27;20;17;37;1500000;324
276;Matt Nieto;SJS;SJS;L;72;10;17;27;20;17;37;925000;325
277;David Pastrnak;BOS;BOS;R;46;10;17;27;20;17;37;925000;326
279;Alex Chiasson;OTT;OTT;R;76;11;15;26;22;15;37;1200000;327
283;John Mitchell;COL;COL;C;68;11;15;26;22;15;37;1800000;328
303;Melker Karlsson;SJS;SJS;C;53;13;11;24;26;11;37;1625000;329
396;Jonas Brodin;MIN;MIN;D;71;3;14;17;9;28;37;4167000;330
225;Jonathan Drouin;TBL;TBL;L;70;4;28;32;8;28;36;3194000;331
256;Joe Colborne;CGY;CGY;C;64;8;20;28;16;20;36;1275000;332
273;David Legwand;BUF;OTT;C;80;9;18;27;18;18;36;3000000;333
278;Nick Spaling;TOR;PIT;C;82;9;18;27;18;18;36;2250000;334
291;Peter Holland;TOR;TOR;C;62;11;14;25;22;14;36;875000;335
298;Travis Zajac;NJD;NJD;C;74;11;14;25;22;14;36;5750000;336
302;Josh Jooris;CGY;CGY;C;60;12;12;24;24;12;36;975000;337
312;Matt Calvert;CLB;CBJ;L;56;13;10;23;26;10;36;2200000;338
259;Chris Kelly;BOS;BOS;C;80;7;21;28;14;21;35;3000000;339
271;Tomas Fleischmann;ANA;FLA, ANA;L;66;8;19;27;16;19;35;0;340
284;Colton Sceviour;DAL;DAL;C;71;9;17;26;18;17;35;650000;341
320;Mason Raymond;CGY;CGY;L;57;12;11;23;24;11;35;3150000;342
449;Andrej Meszaros;BUF;BUF;D;60;7;7;14;21;14;35;0;343
263;Artem Anisimov;CHI;CBJ;C;52;7;20;27;14;20;34;3283000;344
282;Leo Komarov;TOR;TOR;C;62;8;18;26;16;18;34;4099999;345
293;Trevor Lewis;LAK;LAK;C;73;9;16;25;18;16;34;1525000;346
297;Stephen Weiss;#N/A;DET;C;52;9;16;25;18;16;34;99999999;347
308;Linden Vey;VAN;VAN;R;75;10;14;24;20;14;34;1000000;348
318;Adam Lowry;WPG;WPG;L;80;11;12;23;22;12;34;925000;349
345;Tobias Rieder;ARI;ARI;R;72;13;8;21;26;8;34;925000;350
408;Jordie Benn;DAL;DAL;D;73;2;14;16;6;28;34;700000;351
290;Ryan Garbutt;CHI;DAL;L;67;8;17;25;16;17;33;900000;352
294;Riley Nash;CAR;CAR;C;68;8;17;25;16;17;33;1150000;353
319;J.T. Miller;NYR;NYR;C;58;10;13;23;20;13;33;874000;354
420;Jonathan Ericsson;DET;DET;D;82;3;12;15;9;24;33;4250000;355
427;Fedor Tyutin;CLB;CBJ;D;67;3;12;15;9;24;33;4500000;356
431;Nikita Zadorov;COL;BUF;D;60;3;12;15;9;24;33;1744000;357
441;Nicklas Grossmann;ARI;PHI;D;68;5;9;14;15;18;33;3200000;358
444;Nick Holden;COL;COL;D;78;5;9;14;15;18;33;1650000;359
287;Matt Cullen;PIT;NSH;C;62;7;18;25;14;18;32;800000;360
289;Derek Dorsett;VAN;VAN;R;79;7;18;25;14;18;32;2650000;361
301;Martin Hanzal;ARI;ARI;C;37;8;16;24;16;16;32;3100000;362
313;Erik Condra;TBL;OTT;R;68;9;14;23;18;14;32;1250000;363
322;Jiri Sekac;ANA;MTL, ANA;L;69;9;14;23;18;14;32;1350000;364
329;Evander Kane;BUF;WPG;L;37;10;12;22;20;12;32;5250000;365
421;Nate Guenin;COL;COL;D;76;2;13;15;6;26;32;800000;366
422;Barret Jackman;NAS;STL;D;80;2;13;15;6;26;32;2000000;367
425;Nick Schultz;PHI;PHI;D;80;2;13;15;6;26;32;2250000;368
432;Kevin Bieksa;ANA;VAN;D;60;4;10;14;12;20;32;4600000;369
325;Andre Burakovsky;WAS;WSH;L;53;9;13;22;18;13;31;894000;370
342;Joffrey Lupul;TOR;TOR;L;55;10;11;21;20;11;31;5300000;371
366;Chris Terry;CAR;CAR;L;57;11;9;20;22;9;31;875000;372
378;Cedric Paquette;TBL;TBL;C;64;12;7;19;24;7;31;925000;373
387;Dmitrij Jaskin;STL;STL;R;54;13;5;18;26;5;31;894000;374
435;Christian Ehrhoff;LAK;PIT;D;49;3;11;14;9;22;31;1500000;375
436;Alexei Emelin;MTL;MTL;D;68;3;11;14;9;22;31;4099999;376
438;Andrew Ference;EDM;EDM;D;70;3;11;14;9;22;31;3250000;377
451;David Rundblad;CHI;CHI;D;49;3;11;14;9;22;31;1050000;378
452;Luke Schenn;PHI;PHI;D;58;3;11;14;9;22;31;3600000;379
453;Dennis Seidenberg;BOS;BOS;D;82;3;11;14;9;22;31;4000000;380
467;Jakub Kindl;DET;DET;D;35;5;8;13;15;16;31;2400000;381
307;Jordan Staal;CAR;CAR;C;46;6;18;24;12;18;30;6000000;382
333;Pierre-Alexandre Parenteau;TOR;MTL;R;56;8;14;22;16;14;30;2200000;383
348;Jay Beagle;WAS;WSH;R;62;10;10;20;20;10;30;1750000;384
384;Luke Glendening;DET;DET;C;82;12;6;18;24;6;30;628000;385
446;Ben Lovejoy;PIT;ANA, PIT;D;60;2;12;14;6;24;30;1100000;386
448;Jon Merrill;NJD;NJD;D;66;2;12;14;6;24;30;900000;387
455;Mark Stuart;WPG;WPG;D;70;2;12;14;6;24;30;2625000;388
464;Erik Gudbranson;FLA;FLA;D;76;4;9;13;12;18;30;3775000;389
470;Ryan Murphy;CAR;CAR;D;37;4;9;13;12;18;30;1313000;390
476;Brendan Smith;DET;DET;D;76;4;9;13;12;18;30;2750000;391
310;Dave Bolland;FLA;FLA;C;53;6;17;23;12;17;29;5500000;392
326;Johan Franzen;DET;DET;R;33;7;15;22;14;15;29;3955000;393
335;Vincent Trocheck;FLA;FLA;C;50;7;15;22;14;15;29;925000;394
340;Marko Dano;CHI;CBJ;R;35;8;13;21;16;13;29;925000;395
344;Brad Richardson;ARI;VAN;R;45;8;13;21;16;13;29;2083000;396
351;Kyle Brodziak;STL;MIN;C;73;9;11;20;18;11;29;900000;397
377;Jean-Gabriel Pageau;OTT;OTT;C;50;10;9;19;20;9;29;900000;398
398;Brett Connolly;BOS;TBL, BOS;R;55;12;5;17;24;5;29;1024999;399
440;Sergei Gonchar;PIT;DAL, MTL;D;48;1;13;14;3;26;29;0;400
472;Robyn Regehr;#N/A;LAK;D;67;3;10;13;9;20;29;99999999;401
477;Brad Stuart;COL;COL;D;65;3;10;13;9;20;29;3600000;402
479;Patrick Wiercioch;OTT;OTT;D;56;3;10;13;9;20;29;2000000;403
343;Jay McClement;CAR;CAR;C;82;7;14;21;14;14;28;1200000;404
353;Marcus Foligno;BUF;BUF;L;57;8;12;20;16;12;28;1875000;405
358;Vincent Lecavalier;PHI;PHI;C;57;8;12;20;16;12;28;4500000;406
369;Sean Bergenheim;MIN;FLA, MIN;L;56;9;10;19;18;10;28;0;407
373;Mikhail Grabovski;NYI;NYI;C;51;9;10;19;18;10;28;5000000;408
402;Richard Panik;TOR;TOR;R;76;11;6;17;22;6;28;1100000;409
415;Tanner Pearson;LAK;LAK;L;42;12;4;16;24;4;28;1400000;410
459;Jay Bouwmeester;STL;STL;D;72;2;11;13;6;22;28;5400000;411
488;Tom Gilbert;MTL;MTL;D;72;4;8;12;12;16;28;2800000;412
495;Zbynek Michalek;ARI;ARI, STL;D;68;4;8;12;12;16;28;4921000;413
341;Lauri Korpikoski;EDM;ARI;L;69;6;15;21;12;15;27;2500000;414
346;Chris Tierney;SJS;SJS;C;43;6;15;21;12;15;27;894000;415
356;Brooks Laich;WAS;WSH;C;66;7;13;20;14;13;27;4500000;416
360;Andrej Nestrasil;CAR;DET, CAR;C;54;7;13;20;14;13;27;912000;417
382;Casey Cizikas;NYI;NYI;C;70;9;9;18;18;9;27;1000000;418
465;Jan Hejda;COL;COL;D;81;1;12;13;3;24;27;0;419
473;Michal Rozsival;CHI;CHI;D;65;1;12;13;3;24;27;0;420
357;Anton Lander;EDM;EDM;C;38;6;14;20;12;14;26;988000;421
363;Devante Smith-Pelly;MTL;ANA, MTL;R;74;6;14;20;12;14;26;800000;422
371;Jason Chimera;WAS;WSH;L;77;7;12;19;14;12;26;2000000;423
385;Markus Granlund;CGY;CGY;C;48;8;10;18;16;10;26;925000;424
392;Ryan Spooner;BOS;BOS;C;29;8;10;18;16;10;26;950000;425
400;Boone Jenner;CLB;CBJ;C;31;9;8;17;18;8;26;894000;426
412;Zack Kassian;MTL;VAN;R;42;10;6;16;20;6;26;1750000;427
478;Andrej Sustr;TBL;TBL;D;72;0;13;13;0;26;26;3607000;428
491;Carl Gunnarsson;STL;STL;D;61;2;10;12;6;20;26;2950000;429
493;Andrew MacDonald;PHI;PHI;D;58;2;10;12;6;20;26;5000000;430
370;Paul Byron;CGY;CGY;C;57;6;13;19;12;13;25;900000;431
379;Michael Ryder;NJD;NJD;R;47;6;13;19;12;13;25;0;432
380;Alexander Semin;MTL;CAR;R;57;6;13;19;12;13;25;1100000;433
386;Calle Jarnkrok;NAS;NSH;C;74;7;11;18;14;11;25;735000;434
391;James Sheppard;NYR;SJS, NYR;C;71;7;11;18;14;11;25;0;435
414;Vladislav Namestnikov;TBL;TBL;C;43;9;7;16;18;7;25;874000;436
417;David Clarkson;CLB;TOR, CBJ;R;61;10;5;15;20;5;25;5250000;437
426;Jordin Tootoo;NJD;NJD;R;68;10;5;15;20;5;25;825000;438
484;Calvin de Haan;NYI;NYI;D;65;1;11;12;3;22;25;1967000;439
502;Eric Brewer;TOR;TBL, ANA, TOR;D;44;3;8;11;9;16;25;700000;440
512;Luca Sbisa;VAN;VAN;D;76;3;8;11;9;16;25;3600000;441
513;Ryan Stanton;WAS;VAN;D;54;3;8;11;9;16;25;575000;442
368;Alexander Wennberg;CLB;CBJ;C;68;4;16;20;8;16;24;1400000;443
401;Marcus Kruger;CHI;CHI;C;81;7;10;17;14;10;24;0;444
404;Matt Stajan;CGY;CGY;C;59;7;10;17;14;10;24;3125000;445
407;Taylor Beck;TOR;NSH;L;62;8;8;16;16;8;24;975000;446
411;Matt Hendricks;EDM;EDM;L;71;8;8;16;16;8;24;1850000;447
428;R.J. Umberger;PHI;PHI;C;67;9;6;15;18;6;24;4600000;448
430;Chris VandeVelde;PHI;PHI;C;72;9;6;15;18;6;24;713000;449
490;Eric Gryba;EDM;OTT;D;75;0;12;12;0;24;24;1250000;450
505;Deryk Engelland;CGY;CGY;D;76;2;9;11;6;18;24;2917000;451
506;Matt Hunwick;TOR;NYR;D;55;2;9;11;6;18;24;1744000;452
511;John Moore;NJD;NYR, ARI;D;57;2;9;11;6;18;24;1667000;453
526;Nikita Nikitin;EDM;EDM;D;42;4;6;10;12;12;24;4500000;454
394;Max Talbot;BOS;COL, BOS;C;81;5;13;18;10;13;23;900000;455
395;Nate Thompson;ANA;ANA;C;80;5;13;18;10;13;23;1600000;456
405;Jarret Stoll;NYR;LAK;C;73;6;11;17;12;11;23;800000;457
409;Cal Clutterbuck;NYI;NYI;R;76;7;9;16;14;9;23;2750000;458
429;Scottie Upshall;FLA;FLA;L;63;8;7;15;16;7;23;0;459
501;Mark Borowiecki;OTT;OTT;D;63;1;10;11;3;20;23;1100000;460
503;Braydon Coburn;TBL;PHI, TBL;D;43;1;10;11;3;20;23;4500000;461
510;Marc Methot;OTT;OTT;D;45;1;10;11;3;20;23;4900000;462
548;Roman Polak;TOR;TOR;D;56;5;4;9;15;8;23;3000000;463
389;Brandon Prust;VAN;MTL;L;82;4;14;18;8;14;22;2500000;464
399;Brian Flynn;MTL;BUF, MTL;C;63;5;12;17;10;12;22;950000;465
413;Johan Larsson;#N/A;BUF;L;39;6;10;16;12;10;22;99999999;466
424;Brad Malone;CAR;CAR;C;65;7;8;15;14;8;22;650000;467
447;Matt Martin;NYI;NYI;L;78;8;6;14;16;6;22;1000000;468
515;Brett Bellemore;CAR;CAR;D;49;2;8;10;6;16;22;0;469
518;Brenden Dillon;SJS;DAL, SJS;D;80;2;8;10;6;16;22;3270000;470
520;Christian Folin;MIN;MIN;D;40;2;8;10;6;16;22;725000;471
522;Ron Hainsey;CAR;CAR;D;81;2;8;10;6;16;22;2833000;472
527;Johnny Oduya;DAL;CHI;D;76;2;8;10;6;16;22;3750000;473
388;Tomas Jurco;DET;DET;R;63;3;15;18;6;15;21;900000;474
406;Tom Wilson;WAS;WSH;R;67;4;13;17;8;13;21;1294000;475
416;Mike Richards;#N/A;LAK;C;53;5;11;16;10;11;21;99999999;476
418;Kyle Clifford;LAK;LAK;L;80;6;9;15;12;9;21;1600000;477
423;Curtis Lazar;OTT;OTT;C;67;6;9;15;12;9;21;1254000;478
442;Erik Haula;MIN;MIN;C;72;7;7;14;14;7;21;1000000;479
454;Ben Smith;SJS;CHI, SJS;R;80;7;7;14;14;7;21;1500000;480
456;Chris Thorburn;WPG;WPG;R;81;7;7;14;14;7;21;1200000;481
463;Michael Grabner;NYI;NYI;R;34;8;5;13;16;5;21;3000000;482
528;Rob Scuderi;PIT;PIT;D;82;1;9;10;3;18;21;3375000;483
534;Chris Butler;STL;STL;D;33;3;6;9;9;12;21;675000;484
535;Jared Cowen;OTT;OTT;D;54;3;6;9;9;12;21;3100000;485
540;Matt Greene;LAK;LAK;D;82;3;6;9;9;12;21;2500000;486
541;Jay Harrison;WPG;CAR, WPG;D;55;3;6;9;9;12;21;1050000;487
544;Jamie McBain;LAK;LAK;D;26;3;6;9;9;12;21;600000;488
419;Nicolas Deslauriers;BUF;BUF;L;82;5;10;15;10;10;20;637000;489
433;Rene Bourque;CLB;MTL, ANA, CBJ;R;51;6;8;14;12;8;20;3333000;490
437;Jesper Fast;NYR;NYR;R;58;6;8;14;12;8;20;950000;491
445;Tyler Kennedy;NYI;SJS, NYI;C;38;6;8;14;12;8;20;0;492
450;Torrey Mitchell;MTL;BUF, MTL;C;65;6;8;14;12;8;20;1200000;493
457;David Booth;TOR;TOR;L;59;7;6;13;14;6;20;775000;494
468;Mark Letestu;EDM;CBJ;C;54;7;6;13;14;6;20;1800000;495
474;Tuomo Ruutu;NJD;NJD;L;77;7;6;13;14;6;20;3800000;496
482;Daniel Briere;#N/A;COL;C;57;8;4;12;16;4;20;0;497
487;Matt Fraser;WPG;BOS, EDM;R;60;8;4;12;16;4;20;650000;498
514;Victor Bartley;NAS;NSH;D;37;0;10;10;0;20;20;667000;499
524;Jyrki Jokipakka;DAL;DAL;D;51;0;10;10;0;20;20;900000;500
443;Martin Havlat;NJD;NJD;L;40;5;9;14;10;9;19;0;501
462;Boyd Gordon;ARI;EDM;C;68;6;7;13;12;7;19;3000000;502
466;Cody Hodgson;NAS;BUF;C;78;6;7;13;12;7;19;1050000;503
471;Daniel Paille;BOS;BOS;L;71;6;7;13;12;7;19;0;504
494;Cody McLeod;COL;COL;L;82;7;5;12;14;5;19;1333000;505
497;Eric Nystrom;NAS;NSH;L;60;7;5;12;14;5;19;2500000;506
531;Nathan Beaulieu;MTL;MTL;D;64;1;8;9;3;16;19;1000000;507
532;Andre Benoit;STL;BUF;D;59;1;8;9;3;16;19;600000;508
537;Tim Gleason;WAS;CAR, WSH;D;72;1;8;9;3;16;19;0;509
543;Olli Maatta;PIT;PIT;D;20;1;8;9;3;16;19;894000;510
553;Robert Bortuzzo;STL;PIT, STL;D;51;3;5;8;9;10;19;1050000;511
561;Willie Mitchell;FLA;FLA;D;66;3;5;8;9;10;19;4333000;512
434;Kyle Chipchura;ARI;ARI;C;70;4;10;14;8;10;18;875000;513
439;Paul Gaustad;NAS;NSH;C;73;4;10;14;8;10;18;3250000;514
461;Stephen Gionta;NJD;NJD;C;61;5;8;13;10;8;18;850000;515
469;Drew Miller;DET;DET;L;82;5;8;13;10;8;18;1350000;516
475;Jim Slater;WPG;WPG;C;82;5;8;13;10;8;18;0;517
480;Pierre-Edouard Bellemare;PHI;PHI;L;81;6;6;12;12;6;18;713000;518
483;Gregory Campbell;CLB;BOS;C;70;6;6;12;12;6;18;1500000;519
499;Ryan Reaves;STL;STL;R;81;6;6;12;12;6;18;1125000;520
500;Ryan White;PHI;PHI;C;34;6;6;12;12;6;18;800000;521
539;Cody Goloubef;CLB;CBJ;D;36;0;9;9;0;18;18;750000;522
547;Adam Pardy;WPG;WPG;D;55;0;9;9;0;18;18;1000000;523
555;Ben Chiarot;WPG;WPG;D;40;2;6;8;6;12;18;850000;524
556;Carlo Colaiacovo;BUF;PHI;D;33;2;6;8;6;12;18;900000;525
557;Mark Fayne;EDM;EDM;D;74;2;6;8;6;12;18;3625000;526
564;Dylan Olsen;FLA;FLA;D;44;2;6;8;6;12;18;1050000;527
570;Matt Tennyson;#N/A;SJS;D;27;2;6;8;6;12;18;0;528
584;Connor Murphy;ARI;ARI;D;73;4;3;7;12;6;18;1150000;529
485;Patrick Dwyer;CAR;CAR;R;71;5;7;12;10;7;17;0;530
504;Pascal Dupuis;PIT;PIT;R;16;6;5;11;12;5;17;3750000;531
507;Jacob Josefson;NJD;NJD;C;62;6;5;11;12;5;17;800000;532
563;Jamie Oleksiak;DAL;DAL;D;36;1;7;8;3;14;17;875000;533
569;Clayton Stoner;ANA;ANA;D;69;1;7;8;3;14;17;3250000;534
458;Gabriel Bourque;NAS;NSH;L;69;3;10;13;6;10;16;866000;535
460;Ryan Carter;MIN;MIN;C;53;3;10;13;6;10;16;625000;536
481;Beau Bennett;PIT;PIT;R;49;4;8;12;8;8;16;800000;537
489;Barclay Goodrow;SJS;SJS;R;60;4;8;12;8;8;16;627000;538
492;Ronalds Kenins;VAN;VAN;L;30;4;8;12;8;8;16;600000;539
496;David Moss;ARI;ARI;R;60;4;8;12;8;8;16;0;540
509;Derek MacKenzie;FLA;FLA;C;82;5;6;11;10;6;16;3425000;541
521;Seth Griffith;#N/A;BOS;C;30;6;4;10;12;4;16;0;542
565;Dalton Prout;CLB;CBJ;D;63;0;8;8;0;16;16;1075000;543
578;Tim Erixon;PIT;CBJ, CHI, TOR;D;42;2;5;7;6;10;16;600000;544
579;Scott Hannan;SJS;SJS;D;58;2;5;7;6;10;16;0;545
583;Kevan Miller;BOS;BOS;D;41;2;5;7;6;10;16;800000;546
586;Nikita Nesterov;TBL;TBL;D;27;2;5;7;6;10;16;1450000;547
587;Derrick Pouliot;PIT;PIT;D;34;2;5;7;6;10;16;1288000;548
588;Nate Prosser;MIN;MIN;D;63;2;5;7;6;10;16;625000;549
591;Brian Strait;NYI;NYI;D;52;2;5;7;6;10;16;775000;550
486;Dennis Everberg;#N/A;COL;R;55;3;9;12;6;9;15;0;551
498;Steve Ott;STL;STL;C;78;3;9;12;6;9;15;2600000;552
517;Andrew Desjardins;CHI;SJS, CHI;L;69;5;5;10;10;5;15;800000;553
519;Emerson Etem;NYR;ANA;R;45;5;5;10;10;5;15;851000;554
546;Jordan Nolan;LAK;LAK;C;60;6;3;9;12;3;15;950000;555
549;Brett Ritchie;#N/A;DAL;R;31;6;3;9;12;3;15;0;556
573;Mark Barberio;MTL;TBL;D;52;1;6;7;3;12;15;600000;557
582;Adam McQuaid;BOS;BOS;D;63;1;6;7;3;12;15;2750000;558
589;Stephane Robidas;TOR;TOR;D;52;1;6;7;3;12;15;4050000;559
593;Mike Weber;BUF;BUF;D;64;1;6;7;3;12;15;1667000;560
516;Matt Cooke;#N/A;MIN;L;29;4;6;10;8;6;14;0;561
523;Olli Jokinen;STL;NSH, TOR, STL;C;62;4;6;10;8;6;14;0;562
525;Joakim Lindstrom;#N/A;STL, TOR;C;53;4;6;10;8;6;14;0;563
530;Dainius Zubrus;#N/A;NJD;L;74;4;6;10;8;6;14;0;564
542;Rob Klinkhammer;EDM;ARI, PIT, EDM;L;69;5;4;9;10;4;14;725000;565
568;Jack Skille;CLB;CBJ;R;45;6;2;8;12;2;14;0;566
592;Anton Volchenkov;NAS;NSH;D;46;0;7;7;0;14;14;0;567
603;Michal Jordan;CAR;CAR;D;38;2;4;6;6;8;14;625000;568
609;Paul Postma;WPG;WPG;D;42;2;4;6;6;8;14;887000;569
508;Maxim Lapierre;PIT;STL, PIT;C;80;2;9;11;4;9;13;0;570
550;Teuvo Teravainen;CHI;CHI;C;34;4;5;9;8;5;13;1344000;571
566;Teemu Pulkkinen;#N/A;DET;L;31;5;3;8;10;3;13;0;572
618;Peter Harrold;STL;NJD;D;43;3;2;5;9;4;13;600000;573
529;Viktor Stalberg;NYR;NSH;L;25;2;8;10;4;8;12;1100000;574
533;J.T. Brown;#N/A;TBL;R;52;3;6;9;6;6;12;0;575
538;Marcel Goc;STL;PIT, STL;C;74;3;6;9;6;6;12;0;576
545;Travis Moen;DAL;MTL, DAL;L;44;3;6;9;6;6;12;1850000;577
551;Joe Vitale;ARI;ARI;C;70;3;6;9;6;6;12;1117000;578
554;Daniel Carcillo;CHI;CHI;L;39;4;4;8;8;4;12;0;579
580;Tim Jackman;ANA;ANA;R;55;5;2;7;10;2;12;700000;580
600;Josh Gorges;BUF;BUF;D;46;0;6;6;0;12;12;3900000;581
602;Korbinian Holzer;ANA;TOR;D;34;0;6;6;0;12;12;750000;582
617;Radko Gudas;PHI;TBL;D;31;2;3;5;6;6;12;992000;583
536;Leon Draisaitl;#N/A;EDM;C;37;2;7;9;4;7;11;0;584
552;Joakim Andersson;DET;DET;C;68;3;5;8;6;5;11;815000;585
558;Matt Halischuk;WPG;WPG;R;47;3;5;8;6;5;11;750000;586
562;Brenden Morrow;TBL;TBL;L;70;3;5;8;6;5;11;0;587
567;Jordan Schroeder;#N/A;MIN;C;25;3;5;8;6;5;11;0;588
585;Chris Neil;OTT;OTT;R;38;4;3;7;8;3;11;1900000;589
622;Martin Marincin;TOR;EDM;D;41;1;4;5;3;8;11;1200000;590
627;Zach Trotman;BOS;BOS;D;27;1;4;5;3;8;11;625000;591
559;Tomas Kopecky;FLA;FLA;R;64;2;6;8;4;6;10;0;592
560;Colin McDonald;#N/A;NYI;R;18;2;6;8;4;6;10;0;593
576;Craig Cunningham;ARI;BOS, ARI;L;51;3;4;7;6;4;10;600000;594
597;Jacob De La Rose;#N/A;MTL;L;33;4;2;6;8;2;10;0;595
606;Jamie McGinn;BUF;COL;L;19;4;2;6;8;2;10;2950000;596
619;Jack Hillen;CAR;WSH, CAR;D;38;0;5;5;0;10;10;0;597
625;Tyson Strachan;MIN;BUF;D;46;0;5;5;0;10;10;650000;598
634;Raphael Diaz;NYR;CGY;D;56;2;2;4;6;4;10;700000;599
638;Brandon Gormley;ARI;ARI;D;27;2;2;4;6;4;10;1076000;600
640;Steven Kampfer;#N/A;FLA;D;25;2;2;4;6;4;10;0;601
571;Corey Tropp;#N/A;CBJ;R;61;1;7;8;2;7;9;0;602
574;Damien Brunner;#N/A;NJD;R;17;2;5;7;4;5;9;0;603
575;Marc-Andre Cliche;COL;COL;C;74;2;5;7;4;5;9;700000;604
581;Tye McGinn;TBL;SJS, ARI;L;51;2;5;7;4;5;9;625000;605
595;Zach Boychuk;#N/A;CAR;L;31;3;3;6;6;3;9;0;606
596;B.J. Crombeen;#N/A;ARI;R;58;3;3;6;6;3;9;0;607
601;Mikhail Grigorenko;COL;BUF;C;25;3;3;6;6;3;9;675000;608
623;Curtis McKenzie;DAL;DAL;L;36;4;1;5;8;1;9;675000;609
630;Adam Clendening;#N/A;CHI, VAN;D;21;1;3;4;3;6;9;0;610
633;Klas Dahlbeck;ARI;CHI, ARI;D;23;1;3;4;3;6;9;851000;611
642;Jordan Leopold;MIN;STL, CBJ, MIN;D;43;1;3;4;3;6;9;0;612
646;Mirco Mueller;SJS;SJS;D;39;1;3;4;3;6;9;1319000;613
648;David Schlemko;CGY;ARI, DAL, CGY;D;44;1;3;4;3;6;9;0;614
649;Nate Schmidt;WAS;WSH;D;39;1;3;4;3;6;9;812000;615
572;Craig Adams;PIT;PIT;R;70;1;6;7;2;6;8;0;616
577;Anthony Duclair;#N/A;NYR;L;18;1;6;7;2;6;8;0;617
590;Nick Shore;#N/A;LAK;C;34;1;6;7;2;6;8;0;618
594;Sven Baertschi;VAN;CGY, VAN;L;18;2;4;6;4;4;8;900000;619
605;Scott Laughton;#N/A;PHI;C;31;2;4;6;4;4;8;0;620
608;Jeremy Morin;CHI;CHI, CBJ;R;43;2;4;6;4;4;8;800000;621
613;Michael Bournival;MTL;MTL;L;29;3;2;5;6;2;8;600000;622
620;William Karlsson;#N/A;ANA, CBJ;C;21;3;2;5;6;2;8;0;623
628;Philip Varone;#N/A;BUF;C;28;3;2;5;6;2;8;0;624
629;Matt Bartkowski;VAN;BOS;D;47;0;4;4;0;8;8;1750000;625
631;Grant Clitsome;WPG;WPG;D;24;0;4;4;0;8;8;2067000;626
635;Taylor Fedun;#N/A;SJS;D;7;0;4;4;0;8;8;0;627
636;Mark Fraser;NJD;NJD;D;34;0;4;4;0;8;8;0;628
652;Mike Weaver;MTL;MTL;D;31;0;4;4;0;8;8;0;629
662;Petteri Lindbohm;#N/A;STL;D;23;2;1;3;6;2;8;0;630
668;Xavier Ouellet;#N/A;DET;D;21;2;1;3;6;2;8;0;631
674;Mark Pysyk;BUF;BUF;D;7;2;1;3;6;2;8;1125000;632
598;Andrew Ebbett;#N/A;PIT;C;24;1;5;6;2;5;7;0;633
599;Tanner Glass;NYR;NYR;L;66;1;5;6;2;5;7;1450000;634
607;Andrew Miller;#N/A;EDM;C;9;1;5;6;2;5;7;0;635
610;Zac Rinaldo;BOS;PHI;C;58;1;5;6;2;5;7;850000;636
615;Micheal Ferland;#N/A;CGY;L;26;2;3;5;4;3;7;0;637
621;Lucas Lessio;#N/A;ARI;L;26;2;3;5;4;3;7;0;638
624;Trevor Smith;#N/A;TOR;C;54;2;3;5;4;3;7;0;639
637;Simon Gagne;#N/A;BOS;L;23;3;1;4;6;1;7;0;640
650;John Scott;ARI;SJS;L;38;3;1;4;6;1;7;575000;641
660;Brad Hunt;#N/A;EDM;D;11;1;2;3;3;4;7;0;642
665;Ryan Murray;CLB;CBJ;D;12;1;2;3;3;4;7;3494000;643
604;Michael Latta;WAS;WSH;C;53;0;6;6;0;6;6;575000;644
611;Jared Boll;CLB;CBJ;R;72;1;4;5;2;4;6;1700000;645
612;Brandon Bollig;CGY;CGY;L;62;1;4;5;2;4;6;1250000;646
614;Michael Chaput;#N/A;CBJ;C;33;1;4;5;2;4;6;0;647
626;Shawn Thornton;FLA;FLA;L;46;1;4;5;2;4;6;1300000;648
639;Jesse Joensuu;#N/A;EDM;L;20;2;2;4;4;2;6;0;649
641;Brandon Kozun;#N/A;TOR;R;20;2;2;4;4;2;6;0;650
647;Steven Pinizzotto;#N/A;EDM;R;18;2;2;4;4;2;6;0;651
658;Matt Donovan;BUF;NYI;D;12;0;3;3;0;6;6;825000;652
663;Brandon Manning;PHI;PHI;D;11;0;3;3;0;6;6;625000;653
664;Josh Manson;#N/A;ANA;D;28;0;3;3;0;6;6;0;654
666;Patrik Nemeth;DAL;DAL;D;22;0;3;3;0;6;6;900000;655
670;Stuart Percy;#N/A;TOR;D;9;0;3;3;0;6;6;0;656
671;Alex Petrovic;FLA;FLA;D;33;0;3;3;0;6;6;2500000;657
672;Chris Phillips;OTT;OTT;D;36;0;3;3;0;6;6;2500000;658
678;Chris Summers;#N/A;ARI, NYR;D;20;0;3;3;0;6;6;0;659
616;Brian Gibbons;#N/A;CBJ;C;25;0;5;5;0;5;5;0;660
632;Ryane Clowe;NJD;NJD;L;13;1;3;4;2;3;5;4850000;661
643;Manny Malhotra;MTL;MTL;C;58;1;3;4;2;3;5;0;662
644;Cody McCormick;BUF;BUF;C;33;1;3;4;2;3;5;1500000;663
645;Brandon McMillan;VAN;ARI, VAN;L;58;1;3;4;2;3;5;0;664
651;Zach Sill;WAS;PIT, TOR;C;63;1;3;4;2;3;5;575000;665
653;Andy Andreoff;LAK;LAK;L;18;2;1;3;4;1;5;588000;666
654;Sven Andrighetto;#N/A;MTL;R;12;2;1;3;4;1;5;0;667
659;Luke Gazdic;EDM;EDM;L;40;2;1;3;4;1;5;800000;668
673;Matt Puempel;#N/A;OTT;L;13;2;1;3;4;1;5;0;669
677;Zack Smith;OTT;OTT;C;37;2;1;3;4;1;5;1887000;670
687;Justin Falk;CLB;MIN, CBJ;D;18;1;1;2;3;2;5;600000;671
693;Alexey Marchenko;#N/A;DET;D;13;1;1;2;3;2;5;0;672
655;Adam Burish;#N/A;SJS;R;20;1;2;3;2;2;4;0;673
656;Cory Conacher;#N/A;NYI;C;15;1;2;3;2;2;4;0;674
657;Zac Dalpe;#N/A;BUF;C;21;1;2;3;2;2;4;0;675
669;Iiro Pakarinen;#N/A;EDM;R;17;1;2;3;2;2;4;0;676
676;Drew Shore;#N/A;CGY;C;11;1;2;3;2;2;4;0;677
680;Bryan Allen;#N/A;ANA, MTL;D;11;0;2;2;0;4;4;0;678
681;Danny Biega;#N/A;CAR;D;10;0;2;2;0;4;4;0;679
682;Eric Boulton;NYI;NYI;L;10;2;0;2;4;0;4;0;680
689;Seth Helgeson;#N/A;NJD;D;22;0;2;2;0;4;4;0;681
691;Brian Lashoff;DET;DET;D;11;0;2;2;0;4;4;725000;682
692;Andrew MacWilliam;#N/A;TOR;D;12;0;2;2;0;4;4;0;683
696;David Musil;#N/A;EDM;D;4;0;2;2;0;4;4;0;684
699;Tyler Pitlick;EDM;EDM;R;17;2;0;2;4;0;4;761000;685
704;Bryce Salvador;NJD;NJD;D;15;0;2;2;0;4;4;0;686
708;Jarred Tinordi;#N/A;MTL;D;13;0;2;2;0;4;4;0;687
710;Slava Voynov;#N/A;LAK;D;6;0;2;2;0;4;4;0;688
661;Patrick Kaleta;BUF;BUF;R;42;0;3;3;0;3;3;0;689
667;Joakim Nordstrom;CHI;CHI;L;38;0;3;3;0;3;3;0;690
675;Kerby Rychel;#N/A;CBJ;L;5;0;3;3;0;3;3;0;691
679;Brett Sutter;#N/A;MIN;L;6;0;3;3;0;3;3;0;692
683;Sam Carrick;#N/A;TOR;C;16;1;1;2;2;1;3;0;693
684;Daniel Cleary;DET;DET;R;17;1;1;2;2;1;3;0;694
686;Matt Ellis;#N/A;BUF;L;39;1;1;2;2;1;3;0;695
688;Ryan Hamilton;#N/A;EDM;L;16;1;1;2;2;1;3;0;696
690;Joey Hishon;#N/A;COL;C;13;1;1;2;2;1;3;0;697
694;Kael Mouillierat;#N/A;NYI;L;6;1;1;2;2;1;3;0;698
695;Chris Mueller;#N/A;NYR;C;7;1;1;2;2;1;3;0;699
697;Liam O'Brien;#N/A;WSH;C;13;1;1;2;2;1;3;0;700
698;Anthony Peluso;WPG;WPG;R;49;1;1;2;2;1;3;96000;701
700;Chris Porter;PHI;STL;L;24;1;1;2;2;1;3;575000;702
702;Borna Rendulic;#N/A;COL;R;11;1;1;2;2;1;3;0;703
703;Bryan Rust;#N/A;PIT;R;14;1;1;2;2;1;3;0;704
705;Tim Schaller;#N/A;BUF;C;18;1;1;2;2;1;3;0;705
709;Stephane Veilleux;#N/A;MIN;L;12;1;1;2;2;1;3;0;706
718;Alex Biega;#N/A;VAN;D;7;1;0;1;3;0;3;0;707
727;Frank Corrado;VAN;VAN;D;10;1;0;1;3;0;3;700000;708
729;Brandon Davidson;#N/A;EDM;D;12;1;0;1;3;0;3;0;709
730;Brian Dumoulin;PIT;PIT;D;8;1;0;1;3;0;3;800000;710
747;Joe Morrow;#N/A;BOS;D;15;1;0;1;3;0;3;0;711
685;Sean Collins;#N/A;CBJ;C;8;0;2;2;0;2;2;0;712
701;Ty Rattie;#N/A;STL;R;11;0;2;2;0;2;2;0;713
706;Tim Sestito;#N/A;NJD;L;15;0;2;2;0;2;2;0;714
707;Petr Straka;#N/A;PHI;R;3;0;2;2;0;2;2;0;715
713;Keith Aulie;EDM;EDM;D;31;0;1;1;0;2;2;0;716
714;Casey Bailey;#N/A;TOR;C;6;1;0;1;2;0;2;0;717
715;Keith Ballard;MIN;MIN;D;14;0;1;1;0;2;2;0;718
717;Stu Bickel;#N/A;MIN;D;9;0;1;1;0;2;2;0;719
719;Jonathon Blum;#N/A;MIN;D;4;0;1;1;0;2;2;0;720
720;Reid Boucher;#N/A;NJD;L;11;1;0;1;2;0;2;0;721
721;TJ Brennan;#N/A;TOR;D;6;0;1;1;0;2;2;0;722
722;Chris Brown;#N/A;WSH;C;5;1;0;1;2;0;2;0;723
723;Andrew Campbell;#N/A;ARI;D;33;0;1;1;0;2;2;0;724
725;Mat Clark;#N/A;ANA;D;7;0;1;1;0;2;2;0;725
731;Keaton Ellerby;#N/A;WPG;D;1;0;1;1;0;2;2;0;726
733;Landon Ferraro;#N/A;DET;C;3;1;0;1;2;0;2;0;727
734;TJ Galiardi;#N/A;WPG;L;38;1;0;1;2;0;2;0;728
735;Stanislav Galiev;#N/A;WSH;R;2;1;0;1;2;0;2;0;729
736;Colin Greening;OTT;OTT;L;26;1;0;1;2;0;2;2650000;730
737;Rocco Grimaldi;#N/A;FLA;C;7;1;0;1;2;0;2;0;731
738;Freddie Hamilton;#N/A;SJS, COL;C;18;1;0;1;2;0;2;0;732
739;Justin Hodgman;#N/A;ARI;C;5;1;0;1;2;0;2;0;733
740;Michael Kostka;#N/A;NYR;D;7;0;1;1;0;2;2;0;734
741;Josh Leivo;#N/A;TOR;L;9;1;0;1;2;0;2;0;735
742;Bryan Lerg;#N/A;SJS;C;2;1;0;1;2;0;2;0;736
743;Jonathan Marchessault;#N/A;TBL;C;2;1;0;1;2;0;2;0;737
745;Stefan Matteau;NJD;NJD;L;7;1;0;1;2;0;2;613000;738
749;Shane O'Brien;#N/A;FLA;D;9;0;1;1;0;2;2;0;739
751;Jordan Oesterle;#N/A;EDM;D;6;0;1;1;0;2;2;0;740
753;Michael Paliotta;#N/A;CHI;D;1;0;1;1;0;2;2;0;741
758;Griffin Reinhart;EDM;NYI;D;8;0;1;1;0;2;2;3213000;742
759;Colby Robak;#N/A;FLA, ANA;D;12;0;1;1;0;2;2;0;743
760;Chad Ruhwedel;#N/A;BUF;D;4;0;1;1;0;2;2;0;744
761;Miikka Salomaki;#N/A;NSH;R;1;1;0;1;2;0;2;0;745
762;Jeff Schultz;#N/A;LAK;D;9;0;1;1;0;2;2;0;746
767;Ladislav Smid;CGY;CGY;D;31;0;1;1;0;2;2;3500000;747
768;Frédéric St-Denis;#N/A;CBJ;D;4;0;1;1;0;2;2;0;748
769;Jordan Szwarz;#N/A;ARI;R;9;1;0;1;2;0;2;0;749
771;Christian Thomas;#N/A;MTL;L;18;1;0;1;2;0;2;0;750
772;Trevor van Riemsdyk;#N/A;CHI;D;18;0;1;1;0;2;2;0;751
774;David Warsofsky;#N/A;BOS;D;4;0;1;1;0;2;2;0;752
775;Joe Whitney;#N/A;NJD;R;4;1;0;1;2;0;2;0;753
711;Andrew Agozzino;#N/A;COL;L;1;0;1;1;0;1;1;0;754
712;Josh Anderson;#N/A;CBJ;R;6;0;1;1;0;1;1;0;755
716;Sam Bennett;CGY;CGY;C;1;0;1;1;0;1;1;3194000;756
724;Paul Carey;#N/A;COL;C;10;0;1;1;0;1;1;0;757
726;Andrew Copp;#N/A;WPG;C;1;0;1;1;0;1;1;0;758
728;Adam Cracknell;#N/A;CBJ;R;17;0;1;1;0;1;1;0;759
732;Brian Ferlin;#N/A;BOS;R;7;0;1;1;0;1;1;0;760
744;Jordan Martinook;#N/A;ARI;L;8;0;1;1;0;1;1;0;761
746;Jayson Megna;#N/A;PIT;C;12;0;1;1;0;1;1;0;762
748;Valeri Nichushkin;DAL;DAL;R;8;0;1;1;0;1;1;2125000;763
750;Eric O'Dell;#N/A;WPG;C;11;0;1;1;0;1;1;0;764
752;Magnus Paajarvi;#N/A;STL;L;10;0;1;1;0;1;1;0;765
754;Emile Poirier;#N/A;CGY;L;6;0;1;1;0;1;1;0;766
755;Shane Prince;#N/A;OTT;L;2;0;1;1;0;1;1;0;767
756;Peter Regin;#N/A;CHI;C;4;0;1;1;0;1;1;0;768
757;Sam Reinhart;#N/A;BUF;C;9;0;1;1;0;1;1;0;769
763;Tom Sestito;#N/A;VAN;L;3;0;1;1;0;1;1;0;770
764;Michael Sgarbossa;#N/A;COL;C;3;0;1;1;0;1;1;0;771
765;Brendan Shinnimin;#N/A;ARI;C;12;0;1;1;0;1;1;0;772
766;Mike Sislo;#N/A;NJD;R;10;0;1;1;0;1;1;0;773
770;Daniil Tarasov;#N/A;SJS;R;5;0;1;1;0;1;1;0;774
773;Tomas Vincour;#N/A;COL;C;7;0;1;1;0;1;1;0;775
776;Will Acton;#N/A;EDM;C;3;0;0;0;0;0;0;0;776
777;Luke Adam;NYR;CBJ;C;3;0;0;0;0;0;0;600000;777
778;Jason Akeson;#N/A;PHI;R;13;0;0;0;0;0;0;0;778
779;Conor Allen;#N/A;NYR;D;4;0;0;0;0;0;0;0;779
780;Mark Alt;#N/A;PHI;D;1;0;0;0;0;0;0;0;780
781;Mike Angelidis;#N/A;TBL;L;3;0;0;0;0;0;0;0;781
782;Joel Armia;#N/A;BUF;R;1;0;0;0;0;0;0;0;782
783;Viktor Arvidsson;#N/A;NSH;L;6;0;0;0;0;0;0;0;783
784;Carter Ashton;#N/A;TOR;R;7;0;0;0;0;0;0;0;784
785;Kyle Baun;#N/A;CHI;R;3;0;0;0;0;0;0;0;785
786;Anthony Bitetto;#N/A;NSH;D;7;0;0;0;0;0;0;0;786
787;Jesse Blacker;#N/A;ANA;D;1;0;0;0;0;0;0;0;787
788;Mike Blunden;#N/A;TBL;R;2;0;0;0;0;0;0;0;788
789;Troy Bodie;#N/A;TOR;R;5;0;0;0;0;0;0;0;789
790;Alexandre Bolduc;#N/A;ARI;C;3;0;0;0;0;0;0;0;790
791;Patrick Bordeleau;COL;COL;L;1;0;0;0;0;0;0;1000000;791
792;Ryan Bourque;#N/A;NYR;C;1;0;0;0;0;0;0;0;792
793;Drayson Bowman;#N/A;MTL;L;3;0;0;0;0;0;0;0;793
794;Julien Brouillette;#N/A;WPG;D;1;0;0;0;0;0;0;0;794
795;Patrick Brown;#N/A;CAR;C;7;0;0;0;0;0;0;0;795
796;Mike Brown;SJS;SJS;R;12;0;0;0;0;0;0;1200000;796
797;Jordan Caron;STL;BOS, COL;R;30;0;0;0;0;0;0;600000;797
798;Taylor Chorney;WAS;PIT;D;7;0;0;0;0;0;0;700000;798
799;Rich Clune;#N/A;NSH;L;1;0;0;0;0;0;0;0;799
800;Chris Conner;#N/A;WSH;R;2;0;0;0;0;0;0;0;800
801;Patrice Cormier;#N/A;WPG;C;1;0;0;0;0;0;0;0;801
802;Nick Cousins;#N/A;PHI;C;11;0;0;0;0;0;0;0;802
803;Ryan Craig;#N/A;CBJ;C;2;0;0;0;0;0;0;0;803
804;Kyle Cumiskey;#N/A;CHI;D;7;0;0;0;0;0;0;0;804
805;Jerry D'Amigo;#N/A;BUF;R;9;0;0;0;0;0;0;0;805
806;Phillip Danault;#N/A;CHI;C;2;0;0;0;0;0;0;0;806
807;Brandon Defazio;#N/A;VAN;L;2;0;0;0;0;0;0;0;807
808;Gabriel Dumont;#N/A;MTL;C;3;0;0;0;0;0;0;0;808
809;Stefan Elliott;#N/A;COL;D;5;0;0;0;0;0;0;0;809
810;Bobby Farnham;#N/A;PIT;R;11;0;0;0;0;0;0;0;810
811;Kevin Fiala;#N/A;NSH;L;1;0;0;0;0;0;0;0;811
812;Mark Fistric;#N/A;ANA;D;9;0;0;0;0;0;0;0;812
813;Colin Fraser;#N/A;STL;C;1;0;0;0;0;0;0;0;813
814;Matt Frattin;#N/A;TOR;R;9;0;0;0;0;0;0;0;814
815;Max Friberg;#N/A;ANA;L;1;0;0;0;0;0;0;0;815
816;Tyler Gaudet;#N/A;ARI;C;2;0;0;0;0;0;0;0;816
817;Shayne Gostisbehere;#N/A;PHI;D;2;0;0;0;0;0;0;0;817
818;Petter Granberg;#N/A;TOR;D;7;0;0;0;0;0;0;0;818
819;Tyler Graovac;#N/A;MIN;C;3;0;0;0;0;0;0;0;819
820;Micheal Haley;#N/A;SJS;C;4;0;0;0;0;0;0;0;820
821;Curtis Hamilton;#N/A;EDM;L;1;0;0;0;0;0;0;0;821
822;Scott Harrington;#N/A;PIT;D;10;0;0;0;0;0;0;0;822
823;Ryan Hartman;#N/A;CHI;R;5;0;0;0;0;0;0;0;823
824;Eriah Hayes;#N/A;SJS;R;4;0;0;0;0;0;0;0;824
825;Dany Heatley;#N/A;ANA;L;6;0;0;0;0;0;0;0;825
826;Raman Hrabarenka;#N/A;NJD;D;1;0;0;0;0;0;0;0;826
827;Nicklas Jensen;#N/A;VAN;R;5;0;0;0;0;0;0;0;827
828;Blair Jones;#N/A;PHI;C;4;0;0;0;0;0;0;0;828
829;Alex Khokhlachev;#N/A;BOS;C;3;0;0;0;0;0;0;0;829
830;Carl Klingberg;#N/A;WPG;L;2;0;0;0;0;0;0;0;830
831;Corban Knight;#N/A;CGY;C;2;0;0;0;0;0;0;0;831
832;Slater Koekkoek;#N/A;TBL;D;3;0;0;0;0;0;0;0;832
833;Brett Kulak;#N/A;CGY;D;1;0;0;0;0;0;0;0;833
834;Oliver Lauridsen;#N/A;PHI;D;1;0;0;0;0;0;0;0;834
835;Oscar Lindberg;#N/A;NYR;C;1;0;0;0;0;0;0;0;835
836;Matt Lindblad;#N/A;BOS;C;2;0;0;0;0;0;0;0;836
837;Keegan Lowe;#N/A;CAR;D;2;0;0;0;0;0;0;0;837
838;Ryan Malone;#N/A;NYR;L;6;0;0;0;0;0;0;0;838
839;Jake McCabe;#N/A;BUF;D;2;0;0;0;0;0;0;0;839
840;Brian McGrattan;ANA;CGY;R;8;0;0;0;0;0;0;600000;840
841;Dylan McIlrath;#N/A;NYR;D;1;0;0;0;0;0;0;0;841
842;Greg McKegg;#N/A;TOR;C;3;0;0;0;0;0;0;0;842
843;Travis Morin;#N/A;DAL;C;6;0;0;0;0;0;0;0;843
844;Stefan Noesen;#N/A;ANA;R;1;0;0;0;0;0;0;0;844
845;Darnell Nurse;#N/A;EDM;D;2;0;0;0;0;0;0;0;845
846;Steve Oleksy;#N/A;WSH;D;1;0;0;0;0;0;0;0;846
847;Colton Orr;#N/A;TOR;R;1;0;0;0;0;0;0;0;847
848;Greg Pateryn;#N/A;MTL;D;17;0;0;0;0;0;0;0;848
849;Joe Piskula;#N/A;NSH;D;1;0;0;0;0;0;0;0;849
850;Corey Potter;CGY;CGY;D;6;0;0;0;0;0;0;0;850
851;John Ramage;#N/A;CGY;D;1;0;0;0;0;0;0;0;851
852;Brendan Ranford;#N/A;DAL;L;1;0;0;0;0;0;0;0;852
853;Dylan Reese;#N/A;ARI;D;1;0;0;0;0;0;0;0;853
854;Max Reinhart;#N/A;CGY;C;4;0;0;0;0;0;0;0;854
855;Rasmus Rissanen;#N/A;CAR;D;6;0;0;0;0;0;0;0;855
856;Bobby Robins;#N/A;BOS;R;3;0;0;0;0;0;0;0;856
857;Henrik Samuelsson;#N/A;ARI;C;3;0;0;0;0;0;0;0;857
858;Philip Samuelsson;#N/A;ARI;D;4;0;0;0;0;0;0;0;858
859;Cameron Schilling;#N/A;WSH;D;4;0;0;0;0;0;0;0;859
860;Devin Setoguchi;#N/A;CGY;R;12;0;0;0;0;0;0;0;860
861;Justin Shugg;#N/A;CAR;R;3;0;0;0;0;0;0;0;861
862;Duncan Siemens;#N/A;COL;D;1;0;0;0;0;0;0;0;862
863;Colin Smith;#N/A;COL;C;1;0;0;0;0;0;0;0;863
864;Karl Stollery;#N/A;COL, SJS;D;10;0;0;0;0;0;0;0;864
865;Ben Street;#N/A;COL;C;3;0;0;0;0;0;0;0;865
866;Brody Sutter;#N/A;CAR;C;4;0;0;0;0;0;0;0;866
867;Eric Tangradi;#N/A;MTL;L;7;0;0;0;0;0;0;0;867
868;Kimmo Timonen;#N/A;CHI;D;16;0;0;0;0;0;0;0;868
869;Dana Tyrell;#N/A;CBJ;C;3;0;0;0;0;0;0;0;869
870;Dominik Uher;#N/A;PIT;C;2;0;0;0;0;0;0;0;870
871;David Van Der Gulik;#N/A;LAK;L;1;0;0;0;0;0;0;0;871
872;Aaron Volpatti;WAS;WSH;L;2;0;0;0;0;0;0;0;872
873;Chris Wagner;#N/A;ANA;R;9;0;0;0;0;0;0;0;873
874;Scott Wilson;#N/A;PIT;L;1;0;0;0;0;0;0;0;874
875;Garrett Wilson;#N/A;FLA;L;2;0;0;0;0;0;0;0;875
876;Ryan Wilson;COL;COL;D;3;0;0;0;0;0;0;0;876
877;Luke Witkowski;#N/A;TBL;D;16;0;0;0;0;0;0;0;877
878;David Wolf;#N/A;CGY;L;3;0;0;0;0;0;0;0;878
879;Brendan Woods;#N/A;CAR;L;2;0;0;0;0;0;0;0;879
880;Tyler Wotherspoon;#N/A;CGY;D;1;0;0;0;0;0;0;0;880
881;Bogdan Yakimov;#N/A;EDM;C;1;0;0;0;0;0;0;0;881
882;Harry Zolnierczyk;#N/A;NYI;L;2;0;0;0;0;0;0;0;882