rank;name;old_team;pos;gp;goals;assists;points;f_goals;f_assists;f_points;pm;ppg;shg;f_shg;gw;ot
1;Sidney Crosby;PIT;C;80;36;68;104;72;68;140;18;11;0;0;5;1
2;Ryan Getzlaf;ANA;C;77;31;56;87;62;56;118;28;5;0;0;7;1
3;Claude Giroux;PHI;C;82;28;58;86;56;58;114;7;7;0;0;7;1
4;Tyler Seguin;DAL;C;80;37;47;84;74;47;121;16;11;0;0;8;0
5;Corey Perry;ANA;R;81;43;39;82;86;39;125;32;8;0;0;9;1
6;Phil Kessel;TOR;R;82;37;43;80;74;43;117;-5;8;0;0;6;0
7;Taylor Hall;EDM;L;75;27;53;80;54;53;107;-15;7;0;0;1;1
8;Alex Ovechkin;WSH;R;78;51;28;79;102;28;130;-35;24;0;0;10;3
9;Joe Pavelski;SJS;C;82;41;38;79;82;38;120;23;16;1;2;3;0
10;Jamie Benn;DAL;L;81;34;45;79;68;45;113;21;5;1;2;3;1
11;Nicklas Backstrom;WSH;C;82;18;61;79;36;61;97;-20;6;1;2;1;0
12;Patrick Sharp;CHI;L;82;34;44;78;68;44;112;13;10;0;0;3;1
13;Joe Thornton;SJS;C;82;11;65;76;22;65;87;20;2;0;0;3;1
14;Erik Karlsson;OTT;D;82;20;54;74;40;54;94;-15;5;0;0;1;0
15;Evgeni Malkin;PIT;C;60;23;49;72;46;49;95;10;7;0;0;3;0
16;Patrick Marleau;SJS;L;82;33;37;70;66;37;103;0;11;2;4;4;0
17;Anze Kopitar;LAK;C;82;29;41;70;58;41;99;34;10;0;0;9;2
18;Matt Duchene;COL;C;71;23;47;70;46;47;93;8;5;0;0;6;1
19;Martin St. Louis;TBL, NYR;R;81;30;39;69;60;39;99;13;9;1;2;5;1
20;Patrick Kane;CHI;R;69;29;40;69;58;40;98;7;10;0;0;6;0
21;Blake Wheeler;WPG;R;82;28;41;69;56;41;97;4;8;0;0;4;2
22;Kyle Okposo;NYI;R;71;27;42;69;54;42;96;-9;5;0;0;4;1
23;David Krejci;BOS;C;80;19;50;69;38;50;88;39;3;0;0;6;1
24;Chris Kunitz;PIT;L;78;35;33;68;70;33;103;25;13;0;0;8;0
25;Jonathan Toews;CHI;C;76;28;40;68;56;40;96;26;5;3;6;5;0
26;Thomas Vanek;BUF, NYI, MTL;L;78;27;41;68;54;41;95;7;8;0;0;4;0
27;Jaromir Jagr;NJD;R;82;24;43;67;48;43;91;16;5;0;0;6;1
28;John Tavares;NYI;C;59;24;42;66;48;42;90;-6;8;0;0;4;0
29;Jason Spezza;OTT;C;75;23;43;66;46;43;89;-26;9;0;0;5;0
30;Jordan Eberle;EDM;R;80;28;37;65;56;37;93;-11;7;1;2;4;1
31;Gabriel Landeskog;COL;L;81;26;39;65;52;39;91;21;5;0;0;4;1
32;Ryan O'Reilly;COL;C;80;28;36;64;56;36;92;-1;9;0;0;6;2
33;Bryan Little;WPG;C;82;23;41;64;46;41;87;8;8;2;4;1;0
34;Ryan Johansen;CBJ;C;82;33;30;63;66;30;96;3;7;0;0;5;2
35;Nathan MacKinnon;COL;C;82;24;39;63;48;39;87;20;8;0;0;5;0
36;Alexander Steen;STL;L;68;33;29;62;66;29;95;17;7;1;2;9;0
37;Patrice Bergeron;BOS;C;80;30;32;62;60;32;92;38;7;1;2;7;0
38;Jakub Voracek;PHI;R;82;23;39;62;46;39;85;11;8;0;0;2;0
39;James van Riemsdyk;TOR;L;80;30;31;61;60;31;91;-9;9;2;4;3;0
40;Jarome Iginla;BOS;R;78;30;31;61;60;31;91;34;4;0;0;8;0
41;James Neal;PIT;L;59;27;34;61;54;34;88;15;11;0;0;4;3
42;Eric Staal;CAR;C;79;21;40;61;42;40;82;-13;1;2;4;0;0
43;Duncan Keith;CHI;D;79;6;55;61;12;55;67;22;3;0;0;3;0
44;Max Pacioretty;MTL;L;73;39;21;60;78;21;99;8;10;1;2;11;2
45;Jason Pominville;MIN;R;82;30;30;60;60;30;90;3;7;0;0;5;0
46;Marian Hossa;CHI;R;72;30;30;60;60;30;90;28;4;3;6;4;0
47;Wayne Simmonds;PHI;R;82;29;31;60;58;31;89;-4;15;0;0;4;0
48;Paul Stastny;COL;C;71;25;35;60;50;35;85;9;4;0;0;4;1
49;T.J. Oshie;STL;R;79;21;39;60;42;39;81;19;5;2;4;5;1
50;Milan Lucic;BOS;L;80;24;35;59;48;35;83;30;3;0;0;5;1
51;Ondrej Palat;TBL;L;81;23;36;59;46;36;82;32;3;2;4;3;0
52;Mats Zuccarello;NYR;L;77;19;40;59;38;40;78;11;4;1;2;4;0
53;Kyle Turris;OTT;C;82;26;32;58;52;32;84;22;6;2;4;5;0
54;Valtteri Filppula;TBL;C;75;25;33;58;50;33;83;5;6;0;0;2;0
55;Frans Nielsen;NYI;C;80;25;33;58;50;33;83;-11;5;2;4;0;0
56;David Perron;EDM;L;78;28;29;57;56;29;85;-16;8;1;2;2;0
57;David Backes;STL;C;74;27;30;57;54;30;84;14;10;0;0;5;1
58;Jussi Jokinen;PIT;L;81;21;36;57;42;36;78;12;6;0;0;4;0
59;Derek Stepan;NYR;C;82;17;40;57;34;40;74;12;5;0;0;2;0
60;Zach Parise;MIN;L;67;29;27;56;58;27;85;10;14;1;2;5;0
61;Jaden Schwartz;STL;L;80;25;31;56;50;31;81;28;5;3;6;1;0
62;Shea Weber;NSH;D;79;23;33;56;46;33;79;-2;12;0;0;4;1
63;Dustin Byfuglien;WPG;R;78;20;36;56;40;36;76;-20;8;0;0;1;1
64;Ryan Nugent-Hopkins;EDM;C;80;19;37;56;38;37;75;-12;6;0;0;4;1
65;Clarke MacArthur;OTT;L;79;24;31;55;48;31;79;12;8;1;2;5;1
66;Victor Hedman;TBL;D;75;13;42;55;26;42;68;5;3;0;0;2;0
67;Jeff Skinner;CAR;L;71;33;21;54;66;21;87;-14;11;0;0;6;1
68;Andrew Ladd;WPG;L;78;23;31;54;46;31;77;8;4;0;0;2;0
69;Logan Couture;SJS;C;65;23;31;54;46;31;77;21;4;2;4;6;0
70;Jiri Hudler;CGY;C;75;17;37;54;34;37;71;4;2;0;0;1;1
71;Mikko Koivu;MIN;C;65;11;43;54;22;43;65;0;2;0;0;4;0
72;Brad Marchand;BOS;L;82;25;28;53;50;28;78;36;1;5;10;5;1
73;Patric Hornqvist;NSH;R;76;22;31;53;44;31;75;1;7;0;0;6;0
74;Patrik Elias;NJD;L;65;18;35;53;36;35;71;-4;4;2;4;1;1
75;P.K. Subban;MTL;D;82;10;43;53;20;43;63;-4;4;0;0;1;1
76;Keith Yandle;PHX;D;82;8;45;53;16;45;61;-23;3;0;0;2;1
77;Craig Smith;NSH;C;79;24;28;52;48;28;76;16;7;0;0;4;1
78;Scott Hartnell;PHI;L;78;20;32;52;40;32;72;11;9;0;0;3;0
79;David Desharnais;MTL;C;79;16;36;52;32;36;68;11;3;0;0;2;1
80;Matt Moulson;NYI, BUF, MIN;L;75;23;28;51;46;28;74;2;9;0;0;5;1
81;Brad Richards;NYR;C;82;20;31;51;40;31;71;-8;5;0;0;2;0
82;Radim Vrbata;PHX;R;80;20;31;51;40;31;71;-6;10;0;0;2;0
83;Reilly Smith;BOS;R;82;20;31;51;40;31;71;28;6;0;0;3;0
84;Mikkel Boedker;PHX;L;82;19;32;51;38;32;70;-9;5;0;0;1;0
85;David Legwand;NSH, DET;C;83;14;37;51;28;37;65;-17;6;0;0;4;0
86;Alex Pietrangelo;STL;D;81;8;43;51;16;43;59;20;2;0;0;1;0
87;James Wisniewski;CBJ;D;75;7;44;51;14;44;58;0;3;0;0;1;0
88;Jeff Carter;LAK;C;72;27;23;50;54;23;77;8;8;1;2;5;1
89;Tyler Johnson;TBL;C;82;24;26;50;48;26;74;23;5;5;10;4;0
90;Nazem Kadri;TOR;C;78;20;30;50;40;30;70;-11;7;0;0;2;1
91;Brandon Dubinsky;CBJ;C;76;16;34;50;32;34;66;5;4;2;4;2;0
92;Henrik Sedin;VAN;C;70;11;39;50;22;39;61;3;4;0;0;1;0
93;Joel Ward;WSH;R;82;24;25;49;48;25;73;7;6;2;4;4;0
94;Nick Bonino;ANA;C;77;22;27;49;44;27;71;14;7;0;0;2;1
95;Mike Fisher;NSH;C;75;20;29;49;40;29;69;-4;4;0;0;4;0
96;Tyler Bozak;TOR;C;58;19;30;49;38;30;68;2;5;1;2;1;1
97;Daniel Alfredsson;DET;R;68;18;31;49;36;31;67;2;4;0;0;4;2
98;Niklas Kronwall;DET;D;79;8;41;49;16;41;57;0;5;0;0;0;0
99;Gustav Nyquist;DET;R;57;28;20;48;56;20;76;16;6;0;0;6;1
100;Bobby Ryan;OTT;R;70;23;25;48;46;25;71;7;6;0;0;2;0
101;Brent Burns;SJS;D;69;22;26;48;44;26;70;26;2;0;0;3;0
102;Travis Zajac;NJD;C;80;18;30;48;36;30;66;3;3;0;0;3;1
103;Carl Soderberg;BOS;C;73;16;32;48;32;32;64;4;5;0;0;3;0
104;Henrik Zetterberg;DET;L;45;16;32;48;32;32;64;19;3;0;0;1;0
105;Shane Doan;PHX;R;69;23;24;47;46;24;70;-7;10;0;0;4;0
106;Brandon Saad;CHI;L;78;19;28;47;38;28;66;20;3;0;0;2;0
107;Daniel Sedin;VAN;L;73;16;31;47;32;31;63;0;5;0;0;4;0
108;Mike Ribeiro;PHX;C;80;16;31;47;32;31;63;-13;4;0;0;3;0
109;Mark Giordano;CGY;D;64;14;33;47;28;33;61;12;7;0;0;2;0
110;Matt Niskanen;PIT;D;81;10;36;46;20;36;56;33;3;0;0;6;0
111;Mike Cammalleri;CGY;C;63;26;19;45;52;19;71;-13;6;0;0;8;0
112;Antoine Vermette;PHX;C;82;24;21;45;48;21;69;0;7;3;6;4;1
113;Mason Raymond;TOR;L;82;19;26;45;38;26;64;-6;6;1;2;4;0
114;Derick Brassard;NYR;C;81;18;27;45;36;27;63;2;7;0;0;4;1
115;Kevin Shattenkirk;STL;D;81;10;35;45;20;35;55;1;7;0;0;5;1
116;Joffrey Lupul;TOR;L;69;22;22;44;44;22;66;-15;6;0;0;1;1
117;Cody Hodgson;BUF;C;72;20;24;44;40;24;64;-26;9;0;0;0;0
118;Oliver Ekman-Larsson;PHX;D;80;15;29;44;30;29;59;-4;8;0;0;6;1
119;Andrej Sekera;CAR;D;74;11;33;44;22;33;55;4;4;1;2;1;0
120;Mark Streit;PHI;D;82;10;34;44;20;34;54;3;4;0;0;2;1
121;Marcus Johansson;WSH;C;80;8;36;44;16;36;52;-21;6;0;0;1;0
122;Ryan Kesler;VAN;C;77;25;18;43;50;18;68;-15;9;1;2;5;1
123;Troy Brouwer;WSH;R;82;25;18;43;50;18;68;-6;12;0;0;3;0
124;Adam Henrique;NJD;C;77;25;18;43;50;18;68;3;7;3;6;4;0
125;Tyler Ennis;BUF;C;80;21;22;43;42;22;64;-25;6;0;0;0;0
126;Vladimir Tarasenko;STL;R;64;21;22;43;42;22;64;20;5;0;0;3;0
127;Tomas Plekanec;MTL;C;81;20;23;43;40;23;63;11;3;3;6;5;0
128;Justin Williams;LAK;R;82;19;24;43;38;24;62;14;4;0;0;1;0
129;Olli Jokinen;WPG;C;82;18;25;43;36;25;61;-8;2;0;0;1;0
130;Mathieu Perreault;ANA;C;69;18;25;43;36;25;61;13;4;0;0;1;1
131;Ryan McDonagh;NYR;D;77;14;29;43;28;29;57;11;2;3;6;4;1
132;Ales Hemsky;EDM, OTT;R;75;13;30;43;26;30;56;-15;2;0;0;1;0
133;Ryan Suter;MIN;D;82;8;35;43;16;35;51;15;3;0;0;0;0
134;Andrei Markov;MTL;D;81;7;36;43;14;36;50;12;2;1;2;1;1
135;Alexander Semin;CAR;R;65;22;20;42;44;20;64;1;6;1;2;3;1
136;Andrew Cogliano;ANA;C;82;21;21;42;42;21;63;13;0;3;6;5;0
137;Michael Frolik;WPG;R;81;15;27;42;30;27;57;8;1;0;0;2;0
138;Jason Chimera;WSH;L;82;15;27;42;30;27;57;4;1;0;0;0;0
139;Marek Zidlicky;NJD;D;81;12;30;42;24;30;54;-3;8;0;0;2;1
140;Teddy Purcell;TBL;R;81;12;30;42;24;30;54;-3;3;0;0;4;1
141;Alex Goligoski;DAL;D;81;6;36;42;12;36;48;9;3;0;0;0;0
142;Brayden Schenn;PHI;C;82;20;21;41;40;21;61;0;4;0;0;6;1
143;Brendan Gallagher;MTL;R;81;19;22;41;38;22;60;4;8;0;0;0;0
144;Evander Kane;WPG;L;63;19;22;41;38;22;60;-7;1;2;4;4;0
145;Alex Killorn;TBL;C;82;17;24;41;34;24;58;8;3;0;0;2;1
146;Johan Franzen;DET;R;54;16;25;41;32;25;57;6;7;0;0;4;0
147;Mike Richards;LAK;C;82;11;30;41;22;30;52;-6;4;1;2;3;0
148;Mikael Granlund;MIN;C;63;8;33;41;16;33;49;-3;2;0;0;2;0
149;Brent Seabrook;CHI;D;82;7;34;41;14;34;48;23;3;1;2;0;0
150;Steven Stamkos;TBL;C;37;25;15;40;50;15;65;9;9;1;2;5;1
151;Matt Read;PHI;R;75;22;18;40;44;18;62;-4;0;4;8;3;0
152;Cam Atkinson;CBJ;R;79;21;19;40;42;19;61;-4;4;1;2;5;0
153;Brian Gionta;MTL;R;81;18;22;40;36;22;58;1;2;0;0;3;1
154;Zdeno Chara;BOS;D;77;17;23;40;34;23;57;25;10;0;0;3;0
155;Jordan Staal;CAR;C;82;15;25;40;30;25;55;2;2;1;2;2;0
156;Martin Hanzal;PHX;C;65;15;25;40;30;25;55;-9;5;0;0;2;0
157;Torey Krug;BOS;D;79;14;26;40;28;26;54;18;6;0;0;2;1
158;Roman Josi;NSH;D;72;13;27;40;26;27;53;-2;3;0;0;2;0
159;Rick Nash;NYR;L;65;26;13;39;52;13;65;10;4;2;4;9;0
160;Artem Anisimov;CBJ;C;81;22;17;39;44;17;61;-2;3;2;4;5;0
161;Andrew Shaw;CHI;C;80;20;19;39;40;19;59;12;5;0;0;2;0
162;Tomas Tatar;DET;L;73;19;20;39;38;20;58;12;2;0;0;3;0
163;Mikael Backlund;CGY;C;76;18;21;39;36;21;57;4;5;4;8;3;1
164;Nick Foligno;CBJ;L;70;18;21;39;36;21;57;5;3;0;0;5;0
165;Chris Higgins;VAN;L;78;17;22;39;34;22;56;-14;2;0;0;4;1
166;Milan Michalek;OTT;L;82;17;22;39;34;22;56;-25;4;0;0;1;0
167;Sean Couturier;PHI;C;82;13;26;39;26;26;52;1;0;1;2;2;0
168;Matt Cullen;NSH;C;77;10;29;39;20;29;49;4;1;0;0;2;0
169;Erik Johnson;COL;D;80;9;30;39;18;30;48;5;2;0;0;2;0
170;Jamie McGinn;COL;L;79;19;19;38;38;19;57;-3;5;0;0;3;1
171;Tommy Wingels;SJS;C;77;16;22;38;32;22;54;11;0;2;4;7;1
172;Nick Bjugstad;FLA;C;76;16;22;38;32;22;54;-14;0;1;2;4;0
173;Tyson Barrie;COL;D;64;13;25;38;26;25;51;17;4;0;0;5;3
174;Mike Green;WSH;D;70;9;29;38;18;29;47;-16;3;0;0;2;1
175;Josh Bailey;NYI;L;77;8;30;38;16;30;46;-8;2;0;0;1;0
176;Vincent Lecavalier;PHI;C;69;20;17;37;40;17;57;-16;8;0;0;3;1
177;Chris Kreider;NYR;L;66;17;20;37;34;20;54;14;6;0;0;0;0
178;Pavel Datsyuk;DET;C;45;17;20;37;34;20;54;1;6;0;0;2;0
179;Scottie Upshall;FLA;L;76;15;22;37;30;22;52;1;1;1;2;3;0
180;John Carlson;WSH;D;82;10;27;37;20;27;47;-3;5;0;0;0;0
181;Drew Doughty;LAK;D;78;10;27;37;20;27;47;17;6;0;0;2;0
182;Sam Gagner;EDM;C;67;10;27;37;20;27;47;-29;1;0;0;1;0
183;Loui Eriksson;BOS;R;61;10;27;37;20;27;47;14;2;0;0;2;0
184;Derek Roy;STL;C;75;9;28;37;18;28;46;-1;4;0;0;2;0
185;Brian Campbell;FLA;D;82;7;30;37;14;30;44;-6;2;0;0;2;0
186;Jay Bouwmeester;STL;D;82;4;33;37;8;33;41;26;1;0;0;0;0
187;Brad Boyes;FLA;R;78;21;15;36;42;15;57;-6;2;1;2;1;0
188;Ryan Callahan;NYR, TBL;R;65;17;19;36;34;19;53;1;7;1;2;3;0
189;Benoit Pouliot;NYR;L;80;15;21;36;30;21;51;10;7;0;0;4;0
190;Nino Niederreiter;MIN;R;81;14;22;36;28;22;50;12;2;0;0;1;1
191;Dan Boyle;SJS;D;75;12;24;36;24;24;48;-8;6;0;0;1;1
192;Kris Versteeg;FLA, CHI;L;81;12;24;36;24;24;48;0;1;0;0;1;0
193;Cam Fowler;ANA;D;70;6;30;36;12;30;42;15;4;1;2;2;0
194;Cody Eakin;DAL;C;81;16;19;35;32;19;51;-9;3;1;2;2;0
195;Dustin Penner;ANA, WSH;R;67;14;21;35;28;21;49;25;5;0;0;2;0
196;Alex Chiasson;DAL;R;79;13;22;35;26;22;48;-21;6;0;0;4;0
197;Mikhail Grabovski;WSH;C;58;13;22;35;26;22;48;6;3;0;0;1;0
198;Kimmo Timonen;PHI;D;77;6;29;35;12;29;41;5;1;0;0;1;0
199;Sean Monahan;CGY;C;75;22;12;34;44;12;56;-20;3;0;0;2;1
200;Michael Ryder;NJD;R;82;18;16;34;36;16;52;-6;4;1;2;2;0
201;R.J. Umberger;CBJ;C;74;18;16;34;36;16;52;-3;8;1;2;3;0
202;Drew Stafford;BUF;R;70;16;18;34;32;18;50;-19;2;1;2;1;0
203;Valeri Nichushkin;DAL;R;79;14;20;34;28;20;48;20;2;0;0;2;0
204;Mark Scheifele;WPG;C;63;13;21;34;26;21;47;9;1;0;0;2;1
205;Lee Stempniak;CGY, PIT;R;73;12;22;34;24;22;46;-16;0;2;4;1;0
206;Mark Letestu;CBJ;C;82;12;22;34;24;22;46;1;5;1;2;1;0
207;Jason Demers;SJS;D;75;5;29;34;10;29;39;14;1;0;0;0;0
208;Slava Voynov;LAK;D;82;4;30;34;8;30;38;6;1;0;0;0;0
209;Carl Hagelin;NYR;L;72;17;16;33;34;16;50;8;0;1;2;5;0
210;Mika Zibanejad;OTT;C;69;16;17;33;32;17;49;-15;3;0;0;0;0
211;Matt Stajan;CGY;C;63;14;19;33;28;19;47;-13;0;1;2;2;1
212;Pierre-Alexandre Parenteau;COL;R;55;14;19;33;28;19;47;3;1;0;0;1;0
213;Justin Schultz;EDM;D;74;11;22;33;22;22;44;-22;1;0;0;3;0
214;Colin Wilson;NSH;C;81;11;22;33;22;22;44;-1;2;0;0;3;0
215;Vladimir Sobotka;STL;L;61;9;24;33;18;24;42;14;1;0;0;1;0
216;Jason Garrison;VAN;D;81;7;26;33;14;26;40;-5;4;1;2;1;0
217;Christian Ehrhoff;BUF;D;79;6;27;33;12;27;39;-27;1;1;2;2;1
218;Jack Johnson;CBJ;D;82;5;28;33;10;28;38;-7;4;0;0;0;0
219;Cody Franson;TOR;D;79;5;28;33;10;28;38;-20;1;0;0;0;0
220;Ryan Garbutt;DAL;L;75;17;15;32;34;15;49;10;0;2;4;1;0
221;Patrik Berglund;STL;C;78;14;18;32;28;18;46;10;2;0;0;2;0
222;Nick Spaling;NSH;C;71;13;19;32;26;19;45;2;3;1;2;1;0
223;John Mitchell;COL;C;75;11;21;32;22;21;43;13;3;0;0;2;0
224;Ray Whitney;DAL;L;69;9;23;32;18;23;41;-6;3;0;0;0;0
225;Andy Greene;NJD;D;82;8;24;32;16;24;40;3;3;0;0;3;2
226;Justin Faulk;CAR;D;76;5;27;32;10;27;37;-9;2;0;0;1;0
227;Nathan Gerbe;CAR;L;81;16;15;31;32;15;47;-6;3;2;4;1;0
228;Kyle Palmieri;ANA;R;71;14;17;31;28;17;45;9;0;0;0;4;1
229;Eric Fehr;WSH;R;73;13;18;31;26;18;44;0;0;0;0;2;0
230;Alex Galchenyuk;MTL;C;65;13;18;31;26;18;44;-12;3;0;0;2;0
231;Jake Gardiner;TOR;D;80;10;21;31;20;21;41;-3;2;1;2;1;0
232;Dion Phaneuf;TOR;D;80;8;23;31;16;23;39;2;2;0;0;0;0
233;Nick Leddy;CHI;D;82;7;24;31;14;24;38;10;4;0;0;1;0
234;TJ Brodie;CGY;D;81;4;27;31;8;27;35;0;1;0;0;2;1
235;Matthew Carle;TBL;D;82;2;29;31;4;29;33;11;1;0;0;0;0
236;Jiri Tlusty;CAR;L;68;16;14;30;32;14;46;2;0;2;4;5;0
237;Dwight King;LAK;L;77;15;15;30;30;15;45;16;0;2;4;3;0
238;Charlie Coyle;MIN;C;70;12;18;30;24;18;42;-7;2;0;0;2;0
239;Marian Gaborik;CBJ, LAK;R;41;11;19;30;22;19;41;7;1;0;0;0;0
240;Tobias Enstrom;WPG;D;82;10;20;30;20;20;40;-9;4;0;0;3;0
241;Rich Peverley;DAL;C;62;7;23;30;14;23;37;-3;0;1;2;2;1
242;Hampus Lindholm;ANA;D;78;6;24;30;12;24;36;29;1;0;0;1;0
243;Daniel Winnik;ANA;C;76;6;24;30;12;24;36;6;0;2;4;2;0
244;Erik Cole;DAL;L;75;16;13;29;32;13;45;-17;3;0;0;4;0
245;Sean Bergenheim;FLA;L;62;16;13;29;32;13;45;-16;3;0;0;3;0
246;Boone Jenner;CBJ;C;72;16;13;29;32;13;45;6;4;0;0;5;0
247;Antoine Roussel;DAL;L;81;14;15;29;28;15;43;-1;0;0;0;2;0
248;Zack Kassian;VAN;R;73;14;15;29;28;15;43;-4;1;0;0;2;0
249;Tyler Toffoli;LAK;C;62;12;17;29;24;17;41;21;1;0;0;5;0
250;Saku Koivu;ANA;C;65;11;18;29;22;18;40;3;0;1;2;1;1
251;Patrick Maroon;ANA;L;62;11;18;29;22;18;40;11;1;0;0;3;0
252;Jacob Trouba;WPG;D;65;10;19;29;20;19;39;4;0;1;2;1;1
253;Olli Maatta;PIT;D;78;9;20;29;18;20;38;8;3;1;2;1;0
254;Kris Russell;CGY;D;68;7;22;29;14;22;36;-11;4;0;0;1;1
255;Eric Gelinas;NJD;D;60;7;22;29;14;22;36;-3;5;0;0;2;1
256;Martin Erat;WSH, PHX;R;70;3;26;29;6;26;32;5;0;0;0;0;0
257;Dany Heatley;MIN;L;76;12;16;28;24;16;40;-18;4;0;0;2;0
258;Matt Cooke;MIN;L;82;10;18;28;20;18;38;8;0;1;2;3;0
259;Joe Colborne;CGY;C;80;10;18;28;20;18;38;-17;1;0;0;1;0
260;Justin Abdelkader;DET;L;70;10;18;28;20;18;38;2;1;0;0;3;0
261;Mike Santorelli;VAN;C;49;10;18;28;20;18;38;9;0;0;0;3;2
262;Jonathan Huberdeau;FLA;L;69;9;19;28;18;19;37;-5;2;0;0;1;0
263;Tomas Fleischmann;FLA;L;80;8;20;28;16;20;36;-18;2;0;0;1;0
264;Marcus Kruger;CHI;C;81;8;20;28;16;20;36;6;0;0;0;2;0
265;Andre Benoit;COL;D;79;7;21;28;14;21;35;2;1;0;0;2;1
266;Andrew MacDonald;NYI, PHI;D;82;4;24;28;8;24;32;-22;2;0;0;2;0
267;Tom Gilbert;FLA;D;73;3;25;28;6;25;31;-5;2;0;0;1;0
268;Dustin Brown;LAK;R;79;15;12;27;30;12;42;7;1;0;0;2;0
269;Devin Setoguchi;WPG;R;75;11;16;27;22;16;38;-7;2;0;0;3;0
270;Teemu Selanne;ANA;R;64;9;18;27;18;18;36;8;4;0;0;3;0
271;Maxime Talbot;PHI, COL;C;81;8;19;27;16;19;35;5;0;1;2;1;0
272;Jarret Stoll;LAK;C;78;8;19;27;16;19;35;9;1;0;0;0;0
273;Ryan Ellis;NSH;D;80;6;21;27;12;21;33;9;0;0;0;2;0
274;Morgan Rielly;TOR;D;73;2;25;27;4;25;29;-13;1;0;0;0;0
275;Chris Stewart;STL, BUF;R;63;15;11;26;30;11;41;0;3;0;0;3;0
276;Brock Nelson;NYI;C;72;14;12;26;28;12;40;-10;3;0;0;1;0
277;Ben Smith;CHI;R;75;14;12;26;28;12;40;3;1;0;0;2;0
278;Dainius Zubrus;NJD;R;82;13;13;26;26;13;39;1;0;0;0;1;0
279;Brandon Sutter;PIT;C;81;13;13;26;26;13;39;-9;2;3;6;1;0
280;Lars Eller;MTL;C;77;12;14;26;24;14;38;-15;2;1;2;3;0
281;Michael Grabner;NYI;R;64;12;14;26;24;14;38;-10;0;3;6;2;2
282;Gabriel Bourque;NSH;L;74;9;17;26;18;17;35;-5;0;0;0;1;0
283;Cory Conacher;OTT, BUF;C;79;7;19;26;14;19;33;1;1;0;0;2;1
284;Ryane Clowe;NJD;L;43;7;19;26;14;19;33;-10;3;0;0;1;0
285;Jared Spurgeon;MIN;D;67;5;21;26;10;21;31;15;2;0;0;1;0
286;Niklas Hjalmarsson;CHI;D;81;4;22;26;8;22;30;11;0;1;2;1;0
287;Fedor Tyutin;CBJ;D;69;4;22;26;8;22;30;6;1;0;0;0;0
288;Tomas Hertl;SJS;C;37;15;10;25;30;10;40;11;3;0;0;3;0
289;Daniel Briere;MTL;C;69;13;12;25;26;12;38;1;4;0;0;1;0
290;Brenden Morrow;STL;L;71;13;12;25;26;12;38;1;4;0;0;3;0
291;Brandon Pirri;CHI, FLA;C;49;13;12;25;26;12;38;6;3;0;0;0;0
292;Marcel Goc;FLA, PIT;C;74;11;14;25;22;14;36;-7;0;0;0;1;0
293;Damien Brunner;NJD;R;60;11;14;25;22;14;36;-11;4;0;0;1;0
294;Nick Holden;COL;D;54;10;15;25;20;15;35;12;2;0;0;2;0
295;Trevor Daley;DAL;D;67;9;16;25;18;16;34;10;1;0;0;3;0
296;Lauri Korpikoski;PHX;L;64;9;16;25;18;16;34;-7;1;0;0;0;0
297;Dougie Hamilton;BOS;D;64;7;18;25;14;18;32;22;2;0;0;1;0
298;Seth Jones;NSH;D;77;6;19;25;12;19;31;-23;2;0;0;2;1
299;Curtis Glencross;CGY;L;38;12;12;24;24;12;36;-11;3;0;0;2;0
300;Nail Yakupov;EDM;R;63;11;13;24;22;13;35;-33;4;0;0;1;0
301;Matt Nieto;SJS;L;66;10;14;24;20;14;34;-4;1;0;0;2;0
302;Riley Nash;CAR;C;73;10;14;24;20;14;34;0;1;0;0;3;0
303;Matt Calvert;CBJ;L;56;9;15;24;18;15;33;-1;2;0;0;1;0
304;Matt Beleskey;ANA;L;55;9;15;24;18;15;33;8;0;0;0;2;0
305;Riley Sheahan;DET;C;42;9;15;24;18;15;33;8;2;0;0;1;0
306;Kyle Brodziak;MIN;C;81;8;16;24;16;16;32;0;0;1;2;1;0
307;Tuomo Ruutu;CAR, NJD;R;76;8;16;24;16;16;32;-18;3;0;0;2;0
308;Aleksander Barkov;FLA;C;54;8;16;24;16;16;32;-3;3;0;0;1;0
309;Dan Girardi;NYR;D;81;5;19;24;10;19;29;6;1;0;0;0;0
310;Marc-Edouard Vlasic;SJS;D;81;5;19;24;10;19;29;31;0;1;2;0;0
311;Jake Muzzin;LAK;D;76;5;19;24;10;19;29;8;1;0;0;0;0
312;Kevin Bieksa;VAN;D;76;4;20;24;8;20;28;-8;1;0;0;1;1
313;Steve Downie;COL, PHI;R;62;4;20;24;8;20;28;1;3;0;0;1;0
314;Shawn Matthias;FLA, VAN;C;77;12;11;23;24;11;35;-3;0;0;0;0;0
315;Brad Richardson;VAN;R;73;11;12;23;22;12;34;1;1;2;4;2;1
316;Ryan Smyth;EDM;L;72;10;13;23;20;13;33;-18;5;0;0;1;0
317;Jakob Silfverberg;ANA;R;52;10;13;23;20;13;33;2;1;2;4;1;0
318;Steve Ott;BUF, STL;C;82;9;14;23;18;14;32;-38;6;0;0;1;0
319;Marc Methot;OTT;D;75;6;17;23;12;17;29;0;0;0;0;1;0
320;Vernon Fiddler;DAL;C;76;6;17;23;12;17;29;3;0;0;0;1;0
321;Johnny Boychuk;BOS;D;75;5;18;23;10;18;28;31;0;0;0;1;0
322;Danny DeKeyser;DET;D;65;4;19;23;8;19;27;10;1;1;2;0;0
323;Patrick Wiercioch;OTT;D;53;4;19;23;8;19;27;-1;3;0;0;0;0
324;Zack Smith;OTT;C;82;13;9;22;26;9;35;-9;0;1;2;4;0
325;Marty Havlat;SJS;R;48;12;10;22;24;10;34;14;1;0;0;2;0
326;Alec Martinez;LAK;D;61;11;11;22;22;11;33;17;3;0;0;2;0
327;Kris Letang;PIT;D;37;11;11;22;22;11;33;-8;6;0;0;1;0
328;Tyler Myers;BUF;D;62;9;13;22;18;13;31;-26;3;0;0;0;0
329;Michael Raffl;PHI;L;68;9;13;22;18;13;31;2;0;0;0;3;0
330;David Moss;PHX;R;79;8;14;22;16;14;30;-1;0;0;0;1;0
331;Patrick Dwyer;CAR;R;75;8;14;22;16;14;30;-2;0;2;4;2;0
332;Zemgus Girgensons;BUF;C;70;8;14;22;16;14;30;-6;0;1;2;1;0
333;Alexander Edler;VAN;D;63;7;15;22;14;15;29;-39;4;0;0;0;0
334;Andrej Meszaros;PHI, BOS;D;52;7;15;22;14;15;29;5;1;0;0;0;0
335;Andrei Loktionov;NJD, CAR;C;68;7;15;22;14;15;29;-2;2;0;0;2;0
336;Dan Hamhuis;VAN;D;79;5;17;22;10;17;27;13;0;0;0;0;0
337;Thomas Hickey;NYI;D;82;4;18;22;8;18;26;5;0;0;0;0;0
338;Radko Gudas;TBL;D;73;3;19;22;6;19;25;2;1;0;0;1;1
339;Sergei Gonchar;DAL;D;76;2;20;22;4;20;24;-12;1;0;0;1;0
340;Eric Nystrom;NSH;L;79;15;6;21;30;6;36;-25;0;1;2;1;0
341;Justin Fontaine;MIN;R;66;13;8;21;26;8;34;6;1;0;0;1;0
342;Paul Gaustad;NSH;C;75;10;11;21;20;11;31;-6;0;0;0;0;0
343;Elias Lindholm;CAR;C;58;9;12;21;18;12;30;-14;4;0;0;2;0
344;Michael Stone;PHX;D;70;8;13;21;16;13;29;-10;2;0;0;1;0
345;Boyd Gordon;EDM;C;74;8;13;21;16;13;29;-15;1;1;2;1;0
346;Gregory Campbell;BOS;C;82;8;13;21;16;13;29;1;0;1;2;2;0
347;Paul Byron;CGY;C;47;7;14;21;14;14;28;6;2;1;2;1;0
348;Sami Vatanen;ANA;D;48;6;15;21;12;15;27;9;2;0;0;0;0
349;Ryan Murray;CBJ;D;66;4;17;21;8;17;25;4;3;0;0;0;0
350;Dennis Wideman;CGY;D;46;4;17;21;8;17;25;-15;2;0;0;0;0
351;Darren Helm;DET;C;42;12;8;20;24;8;32;2;1;2;4;3;0
352;Jannik Hansen;VAN;R;71;11;9;20;22;9;31;-9;0;1;2;3;0
353;Rob Klinkhammer;PHX;C;72;11;9;20;22;9;31;6;1;0;0;1;0
354;Nikolai Kulemin;TOR;L;70;9;11;20;18;11;29;-4;0;0;0;4;0
355;Shawn Horcoff;DAL;C;77;7;13;20;14;13;27;1;4;1;2;0;0
356;Pascal Dupuis;PIT;R;39;7;13;20;14;13;27;6;0;0;0;0;0
357;Kyle Chipchura;PHX;C;80;5;15;20;10;15;25;3;0;0;0;0;0
358;James Sheppard;SJS;L;67;4;16;20;8;16;24;3;0;0;0;0;0
359;Jordie Benn;DAL;D;78;3;17;20;6;17;23;16;1;0;0;0;0
360;Cal Clutterbuck;NYI;R;73;12;7;19;24;7;31;-9;0;3;6;1;0
361;David Booth;VAN;L;66;9;10;19;18;10;28;1;0;0;0;0;0
362;Jonas Brodin;MIN;D;79;8;11;19;16;11;27;0;3;0;0;0;0
363;Dmitry Kulikov;FLA;D;81;8;11;19;16;11;27;-26;2;1;2;0;0
364;Marcus Foligno;BUF;L;74;7;12;19;14;12;26;-17;0;1;2;3;0
365;Brendan Smith;DET;D;71;5;14;19;10;14;24;-2;1;0;0;0;0
366;Nathan Horton;CBJ;R;36;5;14;19;10;14;24;-3;2;0;0;2;0
367;J.T. Brown;TBL;R;63;4;15;19;8;15;23;-9;0;0;0;0;0
368;Matt Irwin;SJS;D;62;2;17;19;4;17;21;5;1;0;0;0;0
369;Jakub Kindl;DET;D;66;2;17;19;4;17;21;-4;0;0;0;0;0
370;Jimmy Hayes;CHI, FLA;R;55;11;7;18;22;7;29;-5;3;0;0;0;0
371;Chris Kelly;BOS;C;57;9;9;18;18;9;27;2;0;1;2;0;0
372;Derek MacKenzie;CBJ;C;71;9;9;18;18;9;27;0;0;2;4;0;0
373;Daniel Paille;BOS;L;72;9;9;18;18;9;27;9;0;1;2;1;0
374;Nikita Kucherov;TBL;R;52;9;9;18;18;9;27;3;3;0;0;3;0
375;Jesse Winchester;FLA;C;52;9;9;18;18;9;27;-2;1;0;0;2;0
376;Viktor Stalberg;NSH;L;70;8;10;18;16;10;26;-14;0;0;0;1;0
377;Colin McDonald;NYI;R;70;8;10;18;16;10;26;-22;0;0;0;0;0
378;Ryan Strome;NYI;C;37;7;11;18;14;11;25;-1;4;0;0;1;0
379;Brian Boyle;NYR;C;82;6;12;18;12;12;24;1;1;0;0;1;0
380;Dominic Moore;NYR;C;73;6;12;18;12;12;24;0;0;1;2;1;0
381;Ben Lovejoy;ANA;D;78;5;13;18;10;13;23;21;0;0;0;2;0
382;Mark Arcobello;EDM;C;41;4;14;18;8;14;22;-7;1;0;0;1;1
383;Travis Hamonic;NYI;D;69;3;15;18;6;15;21;2;2;0;0;0;0
384;Andrew Ference;EDM;D;71;3;15;18;6;15;21;-18;0;0;0;1;1
385;Karl Alzner;WSH;D;82;2;16;18;4;16;20;-7;0;0;0;1;0
386;Matt Bartkowski;BOS;D;64;0;18;18;0;18;18;22;0;0;0;0;0
387;David Jones;CGY;R;48;9;8;17;18;8;26;1;2;0;0;1;0
388;Joakim Andersson;DET;C;65;8;9;17;16;9;25;-11;0;0;0;1;0
389;Jeff Petry;EDM;D;80;7;10;17;14;10;24;-22;1;0;0;0;0
390;Jan Hejda;COL;D;78;6;11;17;12;11;23;8;0;0;0;0;0
391;Brenden Dillon;DAL;D;80;6;11;17;12;11;23;9;0;2;4;1;0
392;Jamie McBain;BUF;D;69;6;11;17;12;11;23;-13;2;0;0;0;0
393;Christopher Tanev;VAN;D;64;6;11;17;12;11;23;12;0;1;2;2;0
394;Colin Greening;OTT;L;76;6;11;17;12;11;23;-15;2;0;0;1;0
395;Braydon Coburn;PHI;D;82;5;12;17;10;12;22;-6;0;1;2;2;0
396;Derek Morris;PHX;D;63;5;12;17;10;12;22;-2;0;0;0;0;0
397;Brian Gibbons;PIT;C;41;5;12;17;10;12;22;5;1;0;0;0;0
398;Justin Braun;SJS;D;82;4;13;17;8;13;21;19;1;0;0;1;0
399;Francois Beauchemin;ANA;D;70;4;13;17;8;13;21;26;1;0;0;1;0
400;Eric Brewer;TBL;D;77;4;13;17;8;13;21;10;0;0;0;2;0
401;Sami Salo;TBL;D;71;4;13;17;8;13;21;11;0;0;0;0;0
402;TJ Galiardi;CGY;L;62;4;13;17;8;13;21;-13;0;1;2;0;0
403;Tyler Kennedy;SJS;R;67;4;13;17;8;13;21;-10;0;0;0;1;0
404;Carl Gunnarsson;TOR;D;80;3;14;17;6;14;20;12;0;0;0;1;0
405;Marco Scandella;MIN;D;76;3;14;17;6;14;20;10;0;0;0;1;0
406;Alexei Emelin;MTL;D;59;3;14;17;6;14;20;-1;1;0;0;0;0
407;Andrew Desjardins;SJS;C;81;3;14;17;6;14;20;-8;0;0;0;1;0
408;Nate Thompson;TBL;C;81;9;7;16;18;7;25;3;0;2;4;1;1
409;Rene Bourque;MTL;R;63;9;7;16;18;7;25;-1;3;0;0;2;0
410;Todd Bertuzzi;DET;R;59;9;7;16;18;7;25;-17;6;0;0;0;0
411;Casey Cizikas;NYI;C;80;6;10;16;12;10;22;-12;1;0;0;1;0
412;Erik Condra;OTT;R;76;6;10;16;12;10;22;0;0;1;2;0;0
413;Dale Weise;VAN, MTL;R;61;6;10;16;12;10;22;3;1;0;0;1;0
414;Blake Comeau;CBJ;L;61;5;11;16;10;11;21;-2;0;0;0;0;0
415;Michal Handzus;CHI;C;59;4;12;16;8;12;20;0;0;1;2;2;0
416;Johnny Oduya;CHI;D;77;3;13;16;6;13;19;11;0;0;0;1;0
417;Michael Del Zotto;NYR, NSH;D;67;3;13;16;6;13;19;-9;1;0;0;0;0
418;Calvin de Haan;NYI;D;51;3;13;16;6;13;19;-7;1;0;0;1;0
419;Chris Butler;CGY;D;82;2;14;16;4;14;18;-23;0;0;0;1;1
420;Matt Donovan;NYI;D;52;2;14;16;4;14;18;-9;1;0;0;0;0
421;Ryan Stanton;VAN;D;64;1;15;16;2;15;17;5;0;0;0;0;0
422;Bryan Bickell;CHI;L;59;11;4;15;22;4;26;-6;0;0;0;2;0
423;Maxim Lapierre;STL;C;71;9;6;15;18;6;24;-3;0;0;0;1;0
424;Brooks Laich;WSH;C;51;8;7;15;16;7;23;-7;1;1;2;1;0
425;Tomas Jurco;DET;R;36;8;7;15;16;7;23;0;2;0;0;0;0
426;Drew Miller;DET;L;82;7;8;15;14;8;22;-11;0;0;0;1;0
427;Jared Cowen;OTT;D;68;6;9;15;12;9;21;0;0;0;0;2;0
428;Erik Haula;MIN;C;46;6;9;15;12;9;21;14;0;1;2;1;0
429;David Savard;CBJ;D;70;5;10;15;10;10;20;2;1;0;0;1;0
430;Lance Bouma;CGY;C;78;5;10;15;10;10;20;-4;0;1;2;0;0
431;Alexandre Burrows;VAN;R;49;5;10;15;10;10;20;-9;2;0;0;0;0
432;Ryan Malone;TBL;L;57;5;10;15;10;10;20;-7;0;0;0;0;0
433;Ron Hainsey;CAR;D;82;4;11;15;8;11;19;-9;0;0;0;1;0
434;John Moore;NYR;D;74;4;11;15;8;11;19;7;0;0;0;2;0
435;Jay Harrison;CAR;D;68;4;11;15;8;11;19;-1;1;0;0;1;1
436;Barret Jackman;STL;D;79;3;12;15;6;12;18;11;0;0;0;1;0
437;Paul Martin;PIT;D;39;3;12;15;6;12;18;-4;1;0;0;2;0
438;Raphael Diaz;MTL, VAN, NYR;D;63;2;13;15;4;13;17;-2;0;0;0;0;0
439;Nikita Nikitin;CBJ;D;66;2;13;15;4;13;17;9;0;0;0;1;1
440;Chris Phillips;OTT;D;70;1;14;15;2;14;16;-12;1;0;0;0;0
441;Ville Leino;BUF;L;58;0;15;15;0;15;15;-16;0;0;0;0;0
442;Anders Lee;NYI;C;22;9;5;14;18;5;23;3;2;0;0;0;0
443;Matt Martin;NYI;L;79;8;6;14;16;6;22;-11;0;0;0;3;0
444;Chris Neil;OTT;R;76;8;6;14;16;6;22;-10;0;0;0;0;0
445;Brandon Bollig;CHI;L;82;7;7;14;14;7;21;-1;0;0;0;1;0
446;Michael Bournival;MTL;L;60;7;7;14;14;7;21;-6;1;0;0;1;0
447;Paul Ranger;TOR;D;53;6;8;14;12;8;20;-1;0;1;2;0;0
448;Robyn Regehr;LAK;D;79;3;11;14;6;11;17;6;0;0;0;1;1
449;Marc Staal;NYR;D;72;3;11;14;6;11;17;-1;1;0;0;0;0
450;Nicklas Grossmann;PHI;D;78;1;13;14;2;13;15;-6;0;0;0;0;0
451;Josh Gorges;MTL;D;66;1;13;14;2;13;15;6;0;0;0;0;0
452;Joe Vitale;PIT;C;53;1;13;14;2;13;15;-1;0;0;0;1;0
453;Manny Malhotra;CAR;C;69;7;6;13;14;6;20;0;0;0;0;1;1
454;Brian Flynn;BUF;C;79;6;7;13;12;7;19;-10;0;1;2;0;0
455;Brandon Prust;MTL;L;52;6;7;13;12;7;19;-1;0;0;0;3;0
456;Cody McLeod;COL;L;71;5;8;13;10;8;18;2;0;1;2;0;0
457;Kyle Quincey;DET;D;82;4;9;13;8;9;17;-5;0;0;0;1;0
458;Roman Polak;STL;D;72;4;9;13;8;9;17;3;0;0;0;0;0
459;Tanner Glass;PIT;L;67;4;9;13;8;9;17;-8;0;0;0;0;0
460;Richard Panik;TBL;R;50;3;10;13;6;10;16;-9;0;0;0;0;0
461;Brooks Orpik;PIT;D;72;2;11;13;4;11;15;-3;0;0;0;0;0
462;Mark Stuart;WPG;D;69;2;11;13;4;11;15;11;0;0;0;0;0
463;Anton Stralman;NYR;D;81;1;12;13;2;12;14;9;0;0;0;0;0
464;Mike Weaver;FLA, MTL;D;72;1;12;13;2;12;14;0;0;0;0;0;0
465;Colton Sceviour;DAL;C;26;8;4;12;16;4;20;-3;2;0;0;2;0
466;Dave Bolland;TOR;C;23;8;4;12;16;4;20;-1;1;1;2;2;1
467;Deryk Engelland;PIT;D;56;6;6;12;12;6;18;-6;0;0;0;1;0
468;Magnus Paajarvi;STL;L;55;6;6;12;12;6;18;-6;0;0;0;1;0
469;Matt D'Agostini;PIT, BUF;R;57;5;7;12;10;7;17;-15;2;0;0;2;1
470;Jeff Halpern;PHX;C;69;5;7;12;10;7;17;-8;0;0;0;1;0
471;Luke Schenn;PHI;D;79;4;8;12;8;8;16;0;0;0;0;0;0
472;Tomas Kopecky;FLA;R;49;4;8;12;8;8;16;0;0;1;2;0;0
473;Drayson Bowman;CAR;L;70;4;8;12;8;8;16;-2;0;0;0;0;0
474;Scott Hannan;SJS;D;56;3;9;12;6;9;15;1;0;0;0;0;0
475;Steve Bernier;NJD;R;78;3;9;12;6;9;15;-15;0;0;0;1;1
476;Dylan Olsen;FLA;D;44;3;9;12;6;9;15;-3;0;0;0;0;0
477;Philip Larsen;EDM;D;30;3;9;12;6;9;15;-4;1;0;0;0;0
478;Ryan Murphy;CAR;D;48;2;10;12;4;10;14;-9;1;0;0;0;0
479;Travis Moen;MTL;L;65;2;10;12;4;10;14;2;0;0;0;0;0
480;Grant Clitsome;WPG;D;32;2;10;12;4;10;14;-5;0;0;0;0;0
481;Scott Gomez;FLA;C;46;2;10;12;4;10;14;-11;0;0;0;0;0
482;Willie Mitchell;LAK;D;76;1;11;12;2;11;13;14;0;0;0;0;0
483;Emerson Etem;ANA;L;29;7;4;11;14;4;18;3;1;1;2;2;0
484;Trevor Lewis;LAK;C;73;6;5;11;12;5;17;-1;0;1;2;2;0
485;Patrick Bordeleau;COL;L;82;6;5;11;12;5;17;-1;0;0;0;1;0
486;Peter Holland;ANA, TOR;C;43;6;5;11;12;5;17;0;1;0;0;0;0
487;Craig Adams;PIT;R;82;5;6;11;10;6;16;-16;0;0;0;0;0
488;David Clarkson;TOR;R;60;5;6;11;10;6;16;-14;1;0;0;1;0
489;Jeremy Morin;CHI;R;24;5;6;11;10;6;16;5;0;0;0;0;0
490;Mark Fayne;NJD;D;72;4;7;11;8;7;15;-5;0;1;2;0;0
491;Stephen Gionta;NJD;C;66;4;7;11;8;7;15;-8;0;1;2;1;0
492;Peter Regin;NYI, CHI;C;61;4;7;11;8;7;15;-5;0;0;0;0;0
493;Michael Kostka;CHI, TBL;D;28;4;7;11;8;7;15;10;0;0;0;1;0
494;Alex Tanguay;COL;L;16;4;7;11;8;7;15;7;0;1;2;2;0
495;Zach Bogosian;WPG;D;55;3;8;11;6;8;14;3;0;0;0;0;0
496;Brad Stuart;SJS;D;61;3;8;11;6;8;14;4;0;0;0;3;1
497;Dmitry Orlov;WSH;D;54;3;8;11;6;8;14;-1;0;0;0;0;0
498;Ian Cole;STL;D;46;3;8;11;6;8;14;15;0;0;0;0;0
499;Lubomir Visnovsky;NYI;D;24;3;8;11;6;8;14;-1;2;0;0;1;1
500;Jon Merrill;NJD;D;52;2;9;11;4;9;13;-3;0;0;0;2;1
501;Eric Gryba;OTT;D;57;2;9;11;4;9;13;9;0;0;0;0;0
502;Chris Thorburn;WPG;R;55;2;9;11;4;9;13;0;0;0;0;1;0
503;Corey Tropp;BUF, CBJ;R;53;2;9;11;4;9;13;3;0;0;0;0;0
504;Sven Baertschi;CGY;L;26;2;9;11;4;9;13;-4;1;0;0;0;0
505;Jonathan Ericsson;DET;D;48;1;10;11;2;10;12;2;0;0;0;0;0
506;Ryan Spooner;BOS;C;23;0;11;11;0;11;11;0;0;0;0;0;0
507;Ryan Carter;NJD;L;62;7;3;10;14;3;17;-6;0;0;0;2;0
508;Yannick Weber;VAN;D;49;6;4;10;12;4;16;-7;3;0;0;2;0
509;Jordan Nolan;LAK;C;64;6;4;10;12;4;16;-1;0;0;0;1;0
510;Stephane Robidas;DAL, ANA;D;38;5;5;10;10;5;15;10;1;0;0;1;1
511;Mark Barberio;TBL;D;49;5;5;10;10;5;15;10;1;0;0;0;0
512;Matt Halischuk;WPG;R;46;5;5;10;10;5;15;-3;0;0;0;1;0
513;Jay McClement;TOR;C;81;4;6;10;8;6;14;-8;0;0;0;1;0
514;Tom Wilson;WSH;R;82;3;7;10;6;7;13;1;1;0;0;0;0
515;B.J. Crombeen;TBL;R;55;3;7;10;6;7;13;-2;0;0;0;1;0
516;Joe Corvo;OTT;D;25;3;7;10;6;7;13;-7;0;0;0;0;0
517;Troy Bodie;TOR;R;47;3;7;10;6;7;13;6;0;0;0;0;0
518;Zbynek Michalek;PHX;D;59;2;8;10;4;8;12;6;0;0;0;1;0
519;Torrey Mitchell;MIN, BUF;C;67;2;8;10;4;8;12;-3;0;0;0;0;0
520;Erik Gustafsson;PHI;D;31;2;8;10;4;8;12;7;0;0;0;0;0
521;Steve Oleksy;WSH;D;33;2;8;10;4;8;12;7;0;0;0;1;0
522;Devante Smith-Pelly;ANA;R;19;2;8;10;4;8;12;5;0;0;0;0;0
523;Cory Sarich;COL;D;54;1;9;10;2;9;11;7;0;0;0;0;0
524;Dennis Seidenberg;BOS;D;34;1;9;10;2;9;11;11;0;0;0;0;0
525;Bryan Allen;ANA;D;68;0;10;10;0;10;10;20;0;0;0;0;0
526;Robert Bortuzzo;PIT;D;54;0;10;10;0;10;10;-3;0;0;0;0;0
527;Tom Sestito;VAN;L;77;5;4;9;10;4;14;-14;1;0;0;0;0
528;Jayson Megna;PIT;C;36;5;4;9;10;4;14;1;0;0;0;2;0
529;Adam Hall;PHI;R;80;4;5;9;8;5;13;-15;0;2;4;0;0
530;Jay Beagle;WSH;R;62;4;5;9;8;5;13;-9;0;0;0;0;0
531;Radek Dvorak;CAR;R;60;4;5;9;8;5;13;3;0;0;0;2;0
532;Pierre-Marc Bouchard;NYI;C;28;4;5;9;8;5;13;-9;1;0;0;1;0
533;Trevor Smith;TOR;C;28;4;5;9;8;5;13;-3;0;0;0;2;1
534;Erik Gudbranson;FLA;D;65;3;6;9;6;6;12;-7;0;0;0;0;0
535;Brian Strait;NYI;D;47;3;6;9;6;6;12;-14;0;0;0;0;0
536;Cody Ceci;OTT;D;49;3;6;9;6;6;12;-5;0;0;0;2;1
537;Evgeny Kuznetsov;WSH;C;17;3;6;9;6;6;12;-2;0;1;2;0;0
538;Kevin Klein;NSH, NYR;D;77;2;7;9;4;7;11;-7;0;0;0;0;0
539;John-Michael Liles;TOR, CAR;D;41;2;7;9;4;7;11;5;1;0;0;0;0
540;Keith Ballard;MIN;D;45;2;7;9;4;7;11;-7;0;0;0;0;0
541;Calle Jarnkrok;NSH;C;12;2;7;9;4;7;11;7;0;0;0;0;0
542;Mike Weber;BUF;D;68;1;8;9;2;8;10;-29;0;0;0;0;0
543;Nate Guenin;COL;D;68;1;8;9;2;8;10;3;0;0;0;0;0
544;Mattias Ekholm;NSH;D;62;1;8;9;2;8;10;-8;0;0;0;0;0
545;David Schlemko;PHX;D;48;1;8;9;2;8;10;2;0;0;0;0;0
546;Shawn Thornton;BOS;L;64;5;3;8;10;3;13;3;0;0;0;1;0
547;Vincent Trocheck;FLA;C;20;5;3;8;10;3;13;-11;1;1;2;0;0
548;Daniel Cleary;DET;R;52;4;4;8;8;4;12;-11;0;0;0;1;0
549;Derek Dorsett;NYR;R;51;4;4;8;8;4;12;-1;0;0;0;0;0
550;Brian McGrattan;CGY;R;76;4;4;8;8;4;12;-4;0;0;0;0;0
551;Mark Stone;OTT;R;19;4;4;8;8;4;12;5;1;0;0;0;0
552;Kyle Clifford;LAK;L;71;3;5;8;6;5;11;6;0;0;0;0;0
553;Ladislav Smid;EDM, CGY;D;73;2;6;8;4;6;10;-10;0;0;0;0;0
554;Henrik Tallinder;BUF;D;64;2;6;8;4;6;10;-21;0;0;0;0;0
555;Brett Bellemore;CAR;D;64;2;6;8;4;6;10;-1;0;0;0;0;0
556;Nate Prosser;MIN;D;53;2;6;8;4;6;10;2;0;0;0;2;1
557;Ryan Reaves;STL;R;63;2;6;8;4;6;10;-1;0;0;0;0;0
558;Tim Kennedy;PHX;L;37;2;6;8;4;6;10;0;0;0;0;0;0
559;Paul Bissonnette;PHX;L;39;2;6;8;4;6;10;6;0;0;0;0;0
560;Michal Rozsival;CHI;D;42;1;7;8;2;7;9;7;0;0;0;0;0
561;Andrej Sustr;TBL;D;43;1;7;8;2;7;9;3;0;0;0;0;0
562;Kevin Connauton;DAL;D;36;1;7;8;2;7;9;-6;0;0;0;0;0
563;Connor Murphy;PHX;D;30;1;7;8;2;7;9;5;0;0;0;1;0
564;Anton Volchenkov;NJD;D;56;0;8;8;0;8;8;3;0;0;0;0;0
565;Matt Hendricks;NSH, EDM;C;77;5;2;7;10;2;12;-11;0;1;2;1;0
566;Drew Shore;FLA;C;24;5;2;7;10;2;12;-1;1;1;2;1;0
567;Zac Dalpe;VAN;C;55;4;3;7;8;3;11;-7;1;0;0;0;0
568;Kevin Westgarth;CAR, CGY;R;48;4;3;7;8;3;11;-4;0;0;0;1;0
569;Rich Clune;NSH;L;58;3;4;7;6;4;10;-7;0;0;0;1;0
570;Tom Pyatt;TBL;C;27;3;4;7;6;4;10;-2;0;0;0;1;0
571;Beau Bennett;PIT;R;21;3;4;7;6;4;10;-2;0;0;0;1;0
572;Eric O'Dell;WPG;C;30;3;4;7;6;4;10;-2;0;0;0;1;0
573;Tanner Pearson;LAK;L;25;3;4;7;6;4;10;2;1;0;0;1;0
574;Sheldon Brookbank;CHI;D;48;2;5;7;4;5;9;2;0;0;0;1;0
575;Matt Frattin;LAK, CBJ;R;44;2;5;7;4;5;9;-4;1;0;0;0;0
576;Cody McCormick;BUF, MIN;C;43;2;5;7;4;5;9;-6;0;0;0;0;0
577;Reid Boucher;NJD;R;23;2;5;7;4;5;9;2;0;0;0;0;0
578;Anton Belov;EDM;D;57;1;6;7;2;6;8;-12;0;0;0;0;0
579;Mark Pysyk;BUF;D;44;1;6;7;2;6;8;-11;0;0;0;1;1
580;Marc-Andre Cliche;COL;C;76;1;6;7;2;6;8;-11;0;0;0;0;0
581;Luke Glendening;DET;C;56;1;6;7;2;6;8;-8;0;0;0;0;0
582;Matt Ellis;BUF;L;50;4;2;6;8;2;10;-6;0;0;0;0;0
583;Quinton Howden;FLA;C;16;4;2;6;8;2;10;0;0;1;2;0;0
584;Eric Tangradi;WPG;L;55;3;3;6;6;3;9;-6;0;0;0;0;0
585;J.T. Miller;NYR;C;30;3;3;6;6;3;9;-6;0;0;0;0;0
586;Mike Hoffman;OTT;L;25;3;3;6;6;3;9;-2;1;0;0;0;0
587;Jordan Schroeder;VAN;C;25;3;3;6;6;3;9;-7;0;0;0;0;0
588;Nicklas Jensen;VAN;R;17;3;3;6;6;3;9;-1;0;0;0;1;0
589;Francis Bouillon;MTL;D;52;2;4;6;4;4;8;-5;0;0;0;1;1
590;Dalton Prout;CBJ;D;49;2;4;6;4;4;8;-7;0;0;0;0;0
591;Keaton Ellerby;WPG;D;51;2;4;6;4;4;8;4;1;0;0;1;0
592;Matt Greene;LAK;D;38;2;4;6;4;4;8;6;0;0;0;0;0
593;Nate Schmidt;WSH;D;29;2;4;6;4;4;8;4;0;0;0;0;0
594;Ryan Jones;EDM;L;52;2;4;6;4;4;8;0;0;0;0;1;0
595;Ryan White;MTL;C;52;2;4;6;4;4;8;-8;0;0;0;1;0
596;Brandon McMillan;PHX;C;22;2;4;6;4;4;8;0;0;0;0;0;0
597;Brian Lashoff;DET;D;75;1;5;6;2;5;7;-2;0;0;0;0;0
598;Tim Gleason;CAR, TOR;D;56;1;5;6;2;5;7;-21;0;0;0;0;0
599;Kevan Miller;BOS;D;47;1;5;6;2;5;7;20;0;0;0;1;0
600;Victor Bartley;NSH;D;50;1;5;6;2;5;7;0;0;0;0;0;0
601;Connor Carrick;WSH;D;34;1;5;6;2;5;7;-9;0;0;0;0;0
602;Luca Sbisa;ANA;D;30;1;5;6;2;5;7;0;0;0;0;0;0
603;Adam McQuaid;BOS;D;30;1;5;6;2;5;7;12;0;0;0;0;0
604;Jordan Leopold;STL;D;27;1;5;6;2;5;7;1;0;0;0;0;0
605;Adam Pardy;WPG;D;60;0;6;6;0;6;6;4;0;0;0;0;0
606;Martin Marincin;EDM;D;44;0;6;6;0;6;6;-2;0;0;0;0;0
607;Ryan Wilson;COL;D;28;0;6;6;0;6;6;1;0;0;0;0;0
608;Taylor Pyatt;NYR, PIT;L;56;4;1;5;8;1;9;-24;1;0;0;1;0
609;Daniel Carcillo;LAK, NYR;L;57;4;1;5;8;1;9;-1;0;0;0;2;0
610;Jason Zucker;MIN;L;21;4;1;5;8;1;9;2;1;0;0;1;0
611;Tim Jackman;CGY, ANA;R;36;4;1;5;8;1;9;-3;0;0;0;0;0
612;Chris Conner;PIT;R;19;4;1;5;8;1;9;-3;0;0;0;0;0
613;Tye McGinn;PHI;L;18;4;1;5;8;1;9;-1;0;0;0;0;0
614;Jesse Joensuu;EDM;L;42;3;2;5;6;2;8;-16;1;0;0;1;0
615;Bracken Kearns;SJS;L;25;3;2;5;6;2;8;-2;1;0;0;0;0
616;Will Acton;EDM;C;30;3;2;5;6;2;8;-2;0;0;0;1;0
617;Brad Malone;COL;C;32;3;2;5;6;2;8;-4;0;0;0;0;0
618;Raffi Torres;SJS;L;5;3;2;5;6;2;8;4;0;0;0;0;0
619;Mike Brown;EDM, SJS;R;56;2;3;5;4;3;7;-9;0;0;0;0;0
620;Patrick Eaves;DET, NSH;R;30;2;3;5;4;3;7;-7;1;0;0;0;0
621;Anthony Peluso;WPG;R;53;2;3;5;4;3;7;-5;0;0;0;0;0
622;Clayton Stoner;MIN;D;63;1;4;5;2;4;6;-6;0;0;0;0;0
623;Ed Jovanovski;FLA;D;37;1;4;5;2;4;6;-6;0;0;0;0;0
624;Mark Fistric;ANA;D;34;1;4;5;2;4;6;9;0;0;0;0;0
625;Filip Forsberg;NSH;C;13;1;4;5;2;4;6;-8;1;0;0;0;0
626;Nick Schultz;EDM, CBJ;D;69;0;5;5;0;5;5;-13;0;0;0;0;0
627;Simon Despres;PIT;D;34;0;5;5;0;5;5;4;0;0;0;0;0
628;Corey Potter;EDM, BOS;D;19;0;5;5;0;5;5;-1;0;0;0;0;0
629;Linden Vey;LAK;R;18;0;5;5;0;5;5;0;0;0;0;0;0
630;Jack Skille;CBJ;R;16;4;0;4;8;0;8;2;0;0;0;1;0
631;Stephane Da Costa;OTT;C;12;3;1;4;6;1;7;2;1;0;0;0;0
632;Rasmus Ristolainen;BUF;D;34;2;2;4;4;2;6;-15;0;0;0;0;0
633;Zac Rinaldo;PHI;C;67;2;2;4;4;2;6;-13;0;0;0;1;0
634;Luke Gazdic;EDM;L;67;2;2;4;4;2;6;-8;0;0;0;0;0
635;Stephen Weiss;DET;C;26;2;2;4;4;2;6;-4;0;0;0;1;1
636;Dustin Jeffrey;PIT, DAL;C;34;2;2;4;4;2;6;-4;0;0;0;0;0
637;Eric Boulton;NYI;L;23;2;2;4;4;2;6;0;0;0;0;0;0
638;Bryce Salvador;NJD;D;40;1;3;4;2;3;5;-2;0;0;0;0;0
639;John Erskine;WSH;D;37;1;3;4;2;3;5;-5;0;0;0;0;0
640;Rostislav Klesla;PHX;D;25;1;3;4;2;3;5;-3;0;0;0;0;0
641;Carlo Colaiacovo;STL;D;25;1;3;4;2;3;5;-4;0;0;0;0;0
642;Colton Sissons;NSH;C;17;1;3;4;2;3;5;0;0;0;0;0;0
643;Michael Latta;WSH;C;17;1;3;4;2;3;5;0;0;0;0;0;0
644;Zach Boychuk;CAR;L;11;1;3;4;2;3;5;2;0;0;0;0;0
645;Rob Scuderi;PIT;D;53;0;4;4;0;4;4;-8;0;0;0;0;0
646;Peter Harrold;NJD;D;33;0;4;4;0;4;4;-2;0;0;0;0;0
647;Johan Larsson;BUF;L;28;0;4;4;0;4;4;0;0;0;0;0;0
648;Mike Komisarek;CAR;D;32;0;4;4;0;4;4;-4;0;0;0;0;0
649;Krys Barch;FLA;R;55;0;4;4;0;4;4;-10;0;0;0;0;0
650;Rickard Rakell;ANA;C;18;0;4;4;0;4;4;-3;0;0;0;0;0
651;Jean-Philippe Cote;TBL;D;19;0;4;4;0;4;4;0;0;0;0;0;0
652;Tyler Wotherspoon;CGY;D;14;0;4;4;0;4;4;-3;0;0;0;0;0
653;Stephane Veilleux;MIN;L;34;3;0;3;6;0;6;-2;0;0;0;0;0
654;Jordan Szwarz;PHX;R;26;3;0;3;6;0;6;-6;0;0;0;1;0
655;Cam Janssen;NJD;R;24;3;0;3;6;0;6;3;0;0;0;0;0
656;Chris Summers;PHX;D;18;2;1;3;4;1;5;0;0;0;0;0;0
657;Mikhail Grigorenko;BUF;C;18;2;1;3;4;1;5;-3;0;0;0;0;0
658;Casey Wellman;WSH;C;13;2;1;3;4;1;5;3;0;0;0;0;0
659;Markus Granlund;CGY;C;7;2;1;3;4;1;5;2;0;1;2;0;0
660;Zenon Konopka;MIN, BUF;C;59;1;2;3;2;2;4;-9;0;0;0;0;0
661;Adam Larsson;NJD;D;26;1;2;3;2;2;4;-1;0;0;0;1;0
662;Jordan Caron;BOS;R;35;1;2;3;2;2;4;-8;0;0;0;0;0
663;Paul Postma;WPG;D;20;1;2;3;2;2;4;1;0;0;0;1;0
664;Aaron Ness;NYI;D;20;1;2;3;2;2;4;-13;0;0;0;0;0
665;Jacob Josefson;NJD;C;27;1;2;3;2;2;4;0;0;1;2;0;0
666;Mikael Samuelsson;DET;R;26;1;2;3;2;2;4;-4;0;0;0;0;0
667;Oscar Klefbom;EDM;D;17;1;2;3;2;2;4;-6;0;0;0;0;0
668;Joakim Nordstrom;CHI;C;16;1;2;3;2;2;4;-2;0;0;0;0;0
669;Jerry D'Amigo;TOR;R;22;1;2;3;2;2;4;-1;0;0;0;0;0
670;Zach Redmond;WPG;D;10;1;2;3;2;2;4;1;0;0;0;0;0
671;Darren Archibald;VAN;R;16;1;2;3;2;2;4;1;0;0;0;0;0
672;Matt Carkner;NYI;D;53;0;3;3;0;3;3;-10;0;0;0;0;0
673;Shane O'Brien;CGY;D;45;0;3;3;0;3;3;-8;0;0;0;0;0
674;Radek Martinek;NYI;D;13;0;3;3;0;3;3;4;0;0;0;0;0
675;Carter Ashton;TOR;R;32;0;3;3;0;3;3;1;0;0;0;0;0
676;Tim Sestito;NJD;L;16;0;3;3;0;3;3;1;0;0;0;0;0
677;Patrick Wey;WSH;D;9;0;3;3;0;3;3;0;0;0;0;0;0
678;Chad Billins;CGY;D;10;0;3;3;0;3;3;-3;0;0;0;0;0
679;Patrice Cormier;WPG;C;9;0;3;3;0;3;3;2;0;0;0;0;0
680;Chuck Kobasew;PIT;R;33;2;0;2;4;0;4;1;0;0;0;2;0
681;Aaron Volpatti;WSH;L;41;2;0;2;4;0;4;-3;0;0;0;0;0
682;Jean-Gabriel Pageau;OTT;C;28;2;0;2;4;0;4;-5;0;0;0;0;0
683;Jay Rosehill;PHI;L;34;2;0;2;4;0;4;-8;0;0;0;0;0
684;Blair Jones;CGY;C;14;2;0;2;4;0;4;0;0;1;2;0;0
685;Matt Fraser;BOS;R;14;2;0;2;4;0;4;0;0;0;0;0;0
686;Harry Zolnierczyk;PIT;L;13;2;0;2;4;0;4;0;0;0;0;0;0
687;Taylor Fedun;EDM;D;4;2;0;2;4;0;4;-1;0;0;0;0;0
688;Alex Grant;ANA;D;2;2;0;2;4;0;4;3;0;0;0;0;0
689;Mark Fraser;TOR, EDM;D;42;1;1;2;2;1;3;-15;0;0;0;0;0
690;John McCarthy;SJS;L;36;1;1;2;2;1;3;-11;0;0;0;0;0
691;Alexander Urbom;WSH;D;20;1;1;2;2;1;3;1;0;0;0;0;0
692;Jim Slater;WPG;C;27;1;1;2;2;1;3;-5;0;0;0;0;0
693;Matt Gilroy;FLA;D;16;1;1;2;2;1;3;-2;0;0;0;0;0
694;Jared Boll;CBJ;R;28;1;1;2;2;1;3;-6;0;0;0;0;0
695;Dmitrij Jaskin;STL;R;18;1;1;2;2;1;3;-3;0;0;0;0;0
696;Matt Dumba;MIN;D;13;1;1;2;2;1;3;-5;1;0;0;0;0
697;Julien Brouillette;WSH;D;10;1;1;2;2;1;3;3;0;0;0;1;0
698;Matt Kassian;OTT;L;33;1;1;2;2;1;3;-1;0;0;0;0;0
699;Brett Sutter;CAR;L;17;1;1;2;2;1;3;-4;0;0;0;1;0
700;Chris Brown;PHX, WSH;C;12;1;1;2;2;1;3;0;0;0;0;0;0
701;Philip Varone;BUF;C;9;1;1;2;2;1;3;-3;0;0;0;0;0
702;David Warsofsky;BOS;D;6;1;1;2;2;1;3;1;0;0;0;0;0
703;Kenny Agostino;CGY;L;8;1;1;2;2;1;3;-2;0;0;0;0;0
704;Josh Leivo;TOR;L;7;1;1;2;2;1;3;0;0;0;0;0;0
705;Simon Moser;NSH;C;6;1;1;2;2;1;3;0;0;0;0;0;0
706;Justin Florek;BOS;L;4;1;1;2;2;1;3;1;0;0;0;0;0
707;Douglas Murray;MTL;D;53;0;2;2;0;2;2;-12;0;0;0;0;0
708;James Wright;WPG;C;59;0;2;2;0;2;2;-3;0;0;0;0;0
709;Alexander Sulzer;BUF;D;25;0;2;2;0;2;2;-3;0;0;0;0;0
710;Jarred Tinordi;MTL;D;22;0;2;2;0;2;2;-2;0;0;0;0;0
711;Tyson Strachan;WSH;D;18;0;2;2;0;2;2;-2;0;0;0;0;0
712;Colby Robak;FLA;D;16;0;2;2;0;2;2;-4;0;0;0;0;0
713;Colin Fraser;LAK;C;33;0;2;2;0;2;2;-4;0;0;0;0;0
714;Kevin Czuczman;NYI;D;13;0;2;2;0;2;2;-5;0;0;0;0;0
715;Justin Falk;NYR;D;21;0;2;2;0;2;2;-5;0;0;0;0;0
716;Nathan Beaulieu;MTL;D;17;0;2;2;0;2;2;6;0;0;0;0;0
717;Derek Grant;OTT;C;20;0;2;2;0;2;2;-3;0;0;0;0;0
718;Linus Omark;EDM, BUF;L;14;0;2;2;0;2;2;-6;0;0;0;0;0
719;Cory Emmerton;DET;C;18;0;2;2;0;2;2;-2;0;0;0;0;0
720;Adam Cracknell;STL;R;19;0;2;2;0;2;2;0;0;0;0;0;0
721;Chris Terry;CAR;L;10;0;2;2;0;2;2;-4;0;0;0;0;0
722;Rostislav Olesz;NJD;L;10;0;2;2;0;2;2;-1;0;0;0;0;0
723;Max Reinhart;CGY;C;8;0;2;2;0;2;2;1;0;0;0;0;0
724;Chris Breen;CGY;D;9;0;2;2;0;2;2;1;0;0;0;0;0
725;Ben Hanowski;CGY;R;11;0;2;2;0;2;2;-2;0;0;0;0;0
726;Andy Miele;PHX;C;7;0;2;2;0;2;2;4;0;0;0;0;0
727;Steven Pinizzotto;EDM;R;6;0;2;2;0;2;2;-1;0;0;0;0;0
728;Lane MacDermid;DAL, CGY;L;7;0;2;2;0;2;2;1;0;0;0;0;0
729;John Scott;BUF;L;56;1;0;1;2;0;2;-12;0;0;0;0;0
730;Nicolas Deslauriers;BUF;L;17;1;0;1;2;0;2;-10;0;0;0;0;0
731;Mike Halmo;NYI;L;20;1;0;1;2;0;2;-1;0;0;0;0;0
732;Frank Corrado;VAN;D;15;1;0;1;2;0;2;-2;0;0;0;0;0
733;Mark Borowiecki;OTT;D;13;1;0;1;2;0;2;-2;0;0;0;0;0
734;Luke Adam;BUF;C;12;1;0;1;2;0;2;0;0;0;0;0;0
735;Mattias Tedenby;NJD;R;15;1;0;1;2;0;2;-8;0;0;0;0;0
736;Brett Connolly;TBL;R;11;1;0;1;2;0;2;-5;0;0;0;1;0
737;Jeremy Welsh;VAN;C;19;1;0;1;2;0;2;-1;0;0;0;0;0
738;John Persson;NYI;L;10;1;0;1;2;0;2;-4;0;0;0;0;0
739;Nikita Zadorov;BUF;D;7;1;0;1;2;0;2;-4;0;0;0;0;0
740;Eriah Hayes;SJS;R;15;1;0;1;2;0;2;-2;0;0;0;0;0
741;Tyler Pitlick;EDM;R;10;1;0;1;2;0;2;-2;0;0;0;0;0
742;Corban Knight;CGY;C;7;1;0;1;2;0;2;-1;0;0;0;0;0
743;Kellan Lain;VAN;C;9;1;0;1;2;0;2;1;0;0;0;0;0
744;John Albert;WPG;C;9;1;0;1;2;0;2;-3;0;0;0;0;0
745;Adam Almquist;DET;D;2;1;0;1;2;0;2;-1;0;0;0;0;0
746;Roman Horak;CGY, EDM;C;3;1;0;1;2;0;2;-1;0;0;0;0;0
747;Carl Klingberg;WPG;L;3;1;0;1;2;0;2;2;0;0;0;0;0
748;Matt Pelech;SJS;R;6;1;0;1;2;0;2;1;0;0;0;1;0
749;Matt Carey;CHI;L;2;1;0;1;2;0;2;-1;0;0;0;0;0
750;Stefan Elliott;COL;D;1;1;0;1;2;0;2;0;0;0;0;0;0
751;Johnny Gaudreau;CGY;L;1;1;0;1;2;0;2;1;0;0;0;0;0
752;Chad Ruhwedel;BUF;D;21;0;1;1;0;1;1;-3;0;0;0;0;0
753;Anton Lander;EDM;C;27;0;1;1;0;1;1;-10;0;0;0;0;0
754;Aaron Rome;DAL;D;25;0;1;1;0;1;1;-6;0;0;0;0;0
755;Jack Hillen;WSH;D;13;0;1;1;0;1;1;-4;0;0;0;0;0
756;David Rundblad;PHX, CHI;D;17;0;1;1;0;1;1;-4;0;0;0;0;0
757;Chris Porter;STL;L;22;0;1;1;0;1;1;-3;0;0;0;0;0
758;Jonathon Blum;MIN;D;15;0;1;1;0;1;1;-1;0;0;0;0;0
759;Michael Chaput;CBJ;C;17;0;1;1;0;1;1;0;0;0;0;0;0
760;Keith Aulie;TBL;D;15;0;1;1;0;1;1;-3;0;0;0;0;0
761;Kevin Porter;BUF;C;12;0;1;1;0;1;1;-5;0;0;0;0;0
762;Chris VandeVelde;PHI;C;18;0;1;1;0;1;1;-3;0;0;0;0;0
763;Ben Street;CGY;C;13;0;1;1;0;1;1;-2;0;0;0;0;0
764;Derek Smith;CGY;D;14;0;1;1;0;1;1;-10;0;0;0;0;0
765;Joey Crabb;FLA;R;9;0;1;1;0;1;1;-2;0;0;0;0;0
766;Brian Dumoulin;PIT;D;6;0;1;1;0;1;1;1;0;0;0;0;0
767;Jake McCabe;BUF;D;7;0;1;1;0;1;1;-3;0;0;0;0;0
768;George Parros;MTL;R;22;0;1;1;0;1;1;-6;0;0;0;0;0
769;Andrew Ebbett;PIT;C;9;0;1;1;0;1;1;-4;0;0;0;0;0
770;Denis Grebeshkov;EDM;D;7;0;1;1;0;1;1;0;0;0;0;0;0
771;Johan Sundstrom;NYI;C;11;0;1;1;0;1;1;0;0;0;0;0;0
772;Alex Petrovic;FLA;D;7;0;1;1;0;1;1;3;0;0;0;0;0
773;Mike Rupp;MIN;L;13;0;1;1;0;1;1;1;0;0;0;0;0
774;Jordin Tootoo;DET;R;11;0;1;1;0;1;1;-3;0;0;0;0;0
775;Ben Eager;EDM;L;7;0;1;1;0;1;1;1;0;0;0;0;0
776;Sean Collins;CBJ;C;6;0;1;1;0;1;1;1;0;0;0;0;0
777;Travis Morin;DAL;C;4;0;1;1;0;1;1;2;0;0;0;0;0
778;David Broll;TOR;L;5;0;1;1;0;1;1;1;0;0;0;0;0
779;Dmitry Korobov;TBL;D;3;0;1;1;0;1;1;0;0;0;0;0;0
780;Nolan Yonkman;ANA;D;2;0;1;1;0;1;1;-1;0;0;0;0;0
781;Cedric Paquette;TBL;C;2;0;1;1;0;1;1;1;0;0;0;0;0
782;Bobby Butler;FLA;R;2;0;1;1;0;1;1;1;0;0;0;0;0
783;Michael Zalewski;VAN;L;2;0;1;1;0;1;1;2;0;0;0;0;0
784;Kris Newbury;PHI;C;4;0;1;1;0;1;1;0;0;0;0;0;0
785;Christian Folin;MIN;D;1;0;1;1;0;1;1;3;0;0;0;0;0
786;Maxime Fortunus;DAL;D;1;0;1;1;0;1;1;1;0;0;0;0;0
787;Jason Akeson;PHI;R;1;0;1;1;0;1;1;1;0;0;0;0;0
788;Colton Orr;TOR;R;54;0;0;0;0;0;0;-3;0;0;0;0;0
789;Zach Sill;PIT;C;20;0;0;0;0;0;0;-4;0;0;0;0;0
790;Brayden McNabb;BUF;D;12;0;0;0;0;0;0;1;0;0;0;0;0
791;Jerred Smithson;TOR;C;18;0;0;0;0;0;0;-5;0;0;0;0;0
792;Adam Burish;SJS;R;15;0;0;0;0;0;0;-4;0;0;0;0;0
793;Cameron Gaunce;DAL;D;9;0;0;0;0;0;0;1;0;0;0;0;0
794;Jamie Oleksiak;DAL;D;7;0;0;0;0;0;0;-3;0;0;0;0;0
795;Jesper Fast;NYR;R;11;0;0;0;0;0;0;-5;0;0;0;0;0
796;Mike Sislo;NJD;R;14;0;0;0;0;0;0;-1;0;0;0;0;0
797;Ryan Whitney;FLA;D;7;0;0;0;0;0;0;-7;0;0;0;0;0
798;Freddie Hamilton;SJS;C;11;0;0;0;0;0;0;-5;0;0;0;0;0
799;Patrik Nemeth;DAL;D;8;0;0;0;0;0;0;-3;0;0;0;0;0
800;Frazer McLaren;TOR;L;27;0;0;0;0;0;0;-2;0;0;0;0;0
801;Mike Mottau;FLA;D;8;0;0;0;0;0;0;-3;0;0;0;0;0
802;Matt Taormina;TBL;D;7;0;0;0;0;0;0;0;0;0;0;0;0
803;Taylor Beck;NSH;L;7;0;0;0;0;0;0;-2;0;0;0;0;0
804;Pierre-Cedric Labrie;TBL;L;13;0;0;0;0;0;0;-4;0;0;0;0;0
805;Hal Gill;PHI;D;6;0;0;0;0;0;0;0;0;0;0;0;0
806;Nick Johnson;BOS;R;9;0;0;0;0;0;0;-4;0;0;0;0;0
807;Scott Mayfield;NYI;D;5;0;0;0;0;0;0;-3;0;0;0;0;0
808;Chris Mueller;DAL;C;9;0;0;0;0;0;0;-2;0;0;0;0;0
809;Louis Leblanc;MTL;C;8;0;0;0;0;0;0;1;0;0;0;0;0
810;Philip Samuelsson;PIT;D;5;0;0;0;0;0;0;-1;0;0;0;0;0
811;Paul Carey;COL;C;12;0;0;0;0;0;0;2;0;0;0;0;0
812;Andrew Alberts;VAN;D;10;0;0;0;0;0;0;1;0;0;0;0;0
813;Brandon Gormley;PHX;D;5;0;0;0;0;0;0;4;0;0;0;0;0
814;David Steckel;ANA;C;6;0;0;0;0;0;0;0;0;0;0;0;0
815;Dana Tyrell;TBL;C;7;0;0;0;0;0;0;0;0;0;0;0;0
816;Xavier Ouellet;DET;D;4;0;0;0;0;0;0;0;0;0;0;0;0
817;Bryce Van Brabant;CGY;L;6;0;0;0;0;0;0;-1;0;0;0;0;0
818;Brett Bulmer;MIN;R;5;0;0;0;0;0;0;-2;0;0;0;0;0
819;Cody Goloubef;CBJ;D;5;0;0;0;0;0;0;0;0;0;0;0;0
820;Arron Asham;NYR;R;6;0;0;0;0;0;0;-5;0;0;0;0;0
821;Conor Allen;NYR;D;3;0;0;0;0;0;0;-1;0;0;0;0;0
822;Mark Cundari;CGY;D;4;0;0;0;0;0;0;-4;0;0;0;0;0
823;Mike Blunden;MTL;R;7;0;0;0;0;0;0;-2;0;0;0;0;0
824;Teuvo Teravainen;CHI;C;3;0;0;0;0;0;0;0;0;0;0;0;0
825;Ryan Craig;CBJ;C;6;0;0;0;0;0;0;-3;0;0;0;0;0
826;Patrick Kaleta;BUF;R;5;0;0;0;0;0;0;-1;0;0;0;0;0
827;Patrick Holland;MTL;R;5;0;0;0;0;0;0;0;0;0;0;0;0
828;Andrew Campbell;LAK;D;3;0;0;0;0;0;0;0;0;0;0;0;0
829;Vladislav Namestnikov;TBL;C;4;0;0;0;0;0;0;-1;0;0;0;0;0
830;Brad Hunt;EDM;D;3;0;0;0;0;0;0;-3;0;0;0;0;0
831;Yann Sauve;VAN;D;3;0;0;0;0;0;0;-2;0;0;0;0;0
832;Landon Ferraro;DET;C;4;0;0;0;0;0;0;0;0;0;0;0;0
833;Gilbert Brule;PHX;C;3;0;0;0;0;0;0;-1;0;0;0;0;0
834;Lucas Lessio;PHX;L;3;0;0;0;0;0;0;-2;0;0;0;0;0
835;Garrett Wilson;FLA;L;3;0;0;0;0;0;0;-1;0;0;0;0;0
836;Brad Mills;CHI;C;3;0;0;0;0;0;0;-1;0;0;0;0;0
837;Zach Trotman;BOS;D;2;0;0;0;0;0;0;0;0;0;0;0;0
838;Tim Erixon;CBJ;D;2;0;0;0;0;0;0;2;0;0;0;0;0
839;Brett Gallant;NYI;L;4;0;0;0;0;0;0;0;0;0;0;0;0
840;Brandon Mashinter;NYR;L;6;0;0;0;0;0;0;-1;0;0;0;0;0
841;Ryan Stoa;WSH;C;3;0;0;0;0;0;0;-1;0;0;0;0;0
842;Pascal Pelletier;VAN;L;3;0;0;0;0;0;0;0;0;0;0;0;0
843;Keith Aucoin;STL;C;2;0;0;0;0;0;0;-3;0;0;0;0;0
844;Joe Piskula;NSH;D;2;0;0;0;0;0;0;1;0;0;0;0;0
845;Matt Lindblad;BOS;C;2;0;0;0;0;0;0;0;0;0;0;0;0
846;Teemu Pulkkinen;DET;L;3;0;0;0;0;0;0;0;0;0;0;0;0
847;Ty Rattie;STL;R;2;0;0;0;0;0;0;-2;0;0;0;0;0
848;Nicolas Deschamps;WSH;C;3;0;0;0;0;0;0;-1;0;0;0;0;0
849;Ryan Hamilton;EDM;L;2;0;0;0;0;0;0;-2;0;0;0;0;0
850;Craig Cunningham;BOS;R;2;0;0;0;0;0;0;0;0;0;0;0;0
851;Aaron Palushaj;CAR;R;2;0;0;0;0;0;0;-1;0;0;0;0;0
852;Ryan Sproul;DET;D;1;0;0;0;0;0;0;0;0;0;0;0;0
853;Adam Payerl;PIT;C;2;0;0;0;0;0;0;-1;0;0;0;0;0
854;Cameron Schilling;WSH;D;1;0;0;0;0;0;0;-2;0;0;0;0;0
855;Matt Hunwick;COL;D;1;0;0;0;0;0;0;0;0;0;0;0;0
856;Jonathan Racine;FLA;D;1;0;0;0;0;0;0;-1;0;0;0;0;0
857;Alexander Khokhlachev;BOS;C;1;0;0;0;0;0;0;0;0;0;0;0;0
858;Christian Thomas;MTL;L;2;0;0;0;0;0;0;-1;0;0;0;0;0
859;Dylan McIlrath;NYR;D;2;0;0;0;0;0;0;-1;0;0;0;0;0
860;Brandon Yip;PHX;R;2;0;0;0;0;0;0;0;0;0;0;0;0
861;Gabriel Dumont;MTL;C;2;0;0;0;0;0;0;0;0;0;0;0;0
862;Bill Arnold;CGY;C;1;0;0;0;0;0;0;-1;0;0;0;0;0
863;Alexey Marchenko;DET;D;1;0;0;0;0;0;0;2;0;0;0;0;0
864;Karl Stollery;COL;D;2;0;0;0;0;0;0;1;0;0;0;0;0
865;Justin Johnson;NYI;R;2;0;0;0;0;0;0;-1;0;0;0;0;0
866;Petter Granberg;TOR;D;1;0;0;0;0;0;0;0;0;0;0;0;0
867;Jamie Devane;TOR;L;2;0;0;0;0;0;0;-1;0;0;0;0;0
868;David Van Der Gulik;COL;L;2;0;0;0;0;0;0;0;0;0;0;0;0
869;Ben Chiarot;WPG;D;1;0;0;0;0;0;0;-3;0;0;0;0;0
870;Nick Drazenovic;PIT;C;1;0;0;0;0;0;0;-1;0;0;0;0;0
871;Cody Kunyk;TBL;R;1;0;0;0;0;0;0;0;0;0;0;0;0
872;Martin St Pierre;MTL;C;1;0;0;0;0;0;0;0;0;0;0;0;0
873;Peter LeBlanc;WSH;C;1;0;0;0;0;0;0;0;0;0;0;0;0
874;Mitch Callahan;DET;R;1;0;0;0;0;0;0;0;0;0;0;0;0
875;Benn Ferriero;VAN;R;2;0;0;0;0;0;0;0;0;0;0;0;0
876;Julian Melchiori;WPG;D;1;0;0;0;0;0;0;-1;0;0;0;0;0
877;Darroll Powe;NYR;C;1;0;0;0;0;0;0;-2;0;0;0;0;0
878;Mark Van Guilder;NSH;C;1;0;0;0;0;0;0;0;0;0;0;0;0
879;Carson McMillan;MIN;R;1;0;0;0;0;0;0;0;0;0;0;0;0
880;Joe Whitney;NJD;R;1;0;0;0;0;0;0;0;0;0;0;0;0
881;Jake Dowell;MIN;C;1;0;0;0;0;0;0;-1;0;0;0;0;0
882;Spencer Abbott;TOR;L;1;0;0;0;0;0;0;-2;0;0;0;0;0
883;Pierre-Luc Letourneau-Leblond;PIT;R;1;0;0;0;0;0;0;0;0;0;0;0;0
884;Greg McKegg;TOR;C;1;0;0;0;0;0;0;0;0;0;0;0;0
885;Cody Bass;CBJ;C;1;0;0;0;0;0;0;0;0;0;0;0;0
886;Joonas Nattinen;MTL;C;1;0;0;0;0;0;0;0;0;0;0;0;0
